43 33
0 0 0 0 0 0 0 0 0 0 0 0 0 0 0 0 0 0 0 0 0 0 0 0 0 0 0 0 0 0 0 0 0 0 0 21 22 0 0 0 0 0 0
0 0 0 0 0 0 0 0 0 0 0 0 0 0 0 0 0 0 0 0 0 0 0 0 0 0 0 0 0 0 0 0 0 0 0 23 24 25 21 22 0 0 0
0 0 0 0 0 0 0 0 0 0 0 0 0 0 0 0 0 0 0 0 0 0 0 0 0 0 0 0 0 0 0 0 0 0 0 28 29 30 23 24 25 26 0
0 0 0 0 0 0 0 0 0 0 0 0 0 0 0 0 0 0 0 0 0 0 0 0 0 0 0 0 0 0 0 0 0 0 0 32 33 34 28 29 30 31 0
0 0 0 0 0 0 0 0 0 0 0 0 0 0 0 0 0 0 0 0 0 0 0 0 0 0 0 0 0 0 0 0 0 0 0 0 35 0 32 33 34 0 0
0 0 0 0 0 0 0 0 0 0 0 0 0 0 0 0 0 0 0 0 0 0 0 0 0 0 0 0 0 0 0 21 22 0 0 0 36 0 0 35 0 0 0
0 0 0 0 0 0 0 0 0 0 0 0 0 0 0 0 0 0 0 0 0 0 0 0 0 0 0 0 0 0 0 23 24 25 26 0 0 0 0 36 21 22 0
0 0 0 0 0 0 0 0 0 0 0 0 0 0 0 0 0 0 0 0 0 0 0 0 0 0 0 0 0 0 27 28 29 30 31 0 0 0 0 0 23 24 25
0 0 0 0 0 0 0 0 0 0 0 0 0 0 0 0 0 0 0 0 0 0 0 0 0 0 0 0 0 0 0 32 33 34 0 0 0 0 0 27 28 29 30
0 0 0 0 0 0 0 0 0 0 0 0 0 0 0 0 0 0 0 0 0 0 0 0 0 0 0 0 0 0 0 0 35 0 0 0 0 0 0 0 32 33 34
0 0 0 0 0 0 0 0 0 0 0 0 0 0 0 0 0 0 0 0 0 0 0 0 0 0 0 0 0 0 0 0 36 0 0 0 0 0 0 0 0 35 0
0 0 0 0 0 0 0 0 0 0 0 0 0 0 0 0 0 0 0 0 0 0 0 0 0 0 0 0 0 0 0 0 0 0 0 0 0 0 0 0 0 36 0
0 0 0 0 0 0 0 0 0 0 0 0 0 0 0 0 0 0 0 0 0 0 0 0 0 0 0 46 0 0 0 0 0 0 0 0 0 0 0 0 0 0 0
0 0 0 0 0 0 0 0 0 0 0 0 0 0 0 0 0 0 0 0 0 0 0 0 0 0 0 0 0 0 0 0 0 0 0 0 0 0 0 0 0 0 0
0 0 7 3 3 3 3 3 3 3 3 3 3 3 3 3 3 3 3 4 0 0 0 7 3 4 0 0 0 0 0 21 22 0 0 0 0 0 0 0 0 21 22
0 0 11 43 39 39 39 39 39 39 39 39 39 39 39 39 39 39 39 39 39 39 39 39 44 9 0 0 0 0 0 23 24 25 26 0 0 0 0 0 0 23 24
0 0 11 37 2 2 2 2 2 2 2 2 2 2 2 2 2 2 2 2 2 2 2 2 38 9 0 0 0 0 27 28 29 30 31 0 0 0 0 0 27 28 29
0 0 11 37 2 2 2 2 2 2 2 2 2 2 2 2 2 2 2 2 2 2 2 2 38 9 0 0 0 0 0 32 33 34 0 0 21 22 0 0 0 32 33
0 0 11 37 2 2 2 2 2 2 2 2 2 2 2 2 2 2 2 2 2 2 2 2 38 9 0 0 0 0 0 0 35 0 0 0 23 24 25 26 0 0 35
0 0 11 37 2 2 2 2 2 2 2 2 2 2 2 2 2 2 2 2 2 2 2 2 38 9 0 0 0 0 0 0 36 0 0 27 28 29 30 31 0 0 36
0 0 11 37 2 2 2 2 2 2 2 2 2 2 2 2 2 2 2 2 2 2 2 2 38 9 0 0 0 0 0 0 0 0 0 0 32 33 34 0 0 0 0
0 0 11 37 2 2 2 2 2 2 2 2 2 2 2 2 2 2 2 2 2 2 2 2 38 9 0 0 0 0 0 0 0 0 0 0 0 35 0 0 0 0 0
0 0 11 37 2 2 2 2 2 2 2 2 2 2 2 2 2 2 2 2 2 2 2 2 38 9 0 0 0 0 0 0 0 0 0 0 0 36 0 0 0 0 0
0 0 11 37 2 2 2 2 2 2 2 2 2 2 2 2 2 2 2 2 2 2 2 2 38 9 0 0 0 0 0 0 0 0 0 0 0 0 0 0 0 0 0
0 0 11 37 2 2 2 2 2 2 2 2 2 2 2 2 2 2 2 2 2 2 2 2 38 9 0 0 0 0 0 0 0 0 0 0 0 0 0 0 0 0 0
0 0 11 37 2 2 2 2 2 2 2 2 2 2 2 2 2 2 2 2 2 2 2 2 38 9 0 0 0 0 0 0 0 0 0 0 0 0 0 0 0 0 0
0 0 11 41 40 40 40 40 40 40 40 2 2 40 40 40 40 40 40 40 40 40 40 40 42 9 0 0 0 0 0 0 0 0 0 0 0 0 0 0 0 0 0
0 0 7 3 3 3 3 3 3 3 4 0 0 7 3 3 3 3 3 3 3 3 3 3 3 4 0 0 0 0 0 0 0 0 0 0 0 0 0 0 0 0 0
0 0 8 5 5 5 5 5 5 5 6 0 0 8 5 5 5 5 5 5 5 5 5 5 5 6 0 0 46 0 0 0 0 0 0 0 0 0 0 0 0 0 0
0 0 0 0 0 0 0 0 0 0 0 1 1 0 0 0 0 0 0 0 0 0 0 0 0 0 0 0 0 0 0 0 0 0 0 0 0 0 0 0 0 0 0
0 0 0 0 0 0 0 0 0 0 0 1 1 0 0 0 0 0 0 0 0 0 0 0 0 0 0 0 0 0 0 0 0 0 0 0 0 0 0 0 0 0 0
0 0 0 0 0 0 0 0 0 0 0 1 1 0 0 0 0 0 0 0 0 0 0 0 0 0 0 0 0 0 0 0 0 0 0 0 0 0 0 0 0 0 0
0 0 0 0 0 0 0 0 0 0 0 1 1 0 0 0 0 0 0 0 0 0 0 0 0 0 0 0 0 0 0 0 0 0 0 0 0 0 0 0 0 0 0