43 33
0 0 0 0 0 0 0 0 0 0 0 27 28 29 30 31 0 0 0 0 0 0 0 0 0 0 0 23 24 25 26 0 0 0 0 0 0 0 0 0 0 0 0
0 0 21 22 0 0 0 0 0 0 0 0 32 33 34 0 0 0 0 0 0 0 21 22 0 0 27 28 29 30 31 0 0 0 21 22 0 0 21 22 0 0 0
0 0 23 24 25 26 0 0 0 0 0 0 0 35 0 0 0 0 0 0 0 0 23 24 25 26 0 32 33 34 0 0 0 0 23 24 25 26 23 24 25 26 0
0 27 28 29 30 31 0 0 0 0 0 0 0 36 0 0 0 21 22 0 0 27 28 29 30 31 0 0 35 0 0 21 22 27 28 29 30 31 28 29 30 31 0
0 0 32 33 34 0 0 0 21 22 0 0 0 0 0 0 0 23 24 25 26 0 32 33 34 0 0 0 36 0 0 23 24 25 32 33 34 0 32 33 34 0 0
0 0 0 35 0 0 0 0 23 24 25 26 0 0 0 0 27 28 29 30 31 0 0 35 0 0 0 0 0 0 27 28 29 30 31 35 0 0 0 35 0 0 0
0 0 0 36 0 0 0 27 28 29 30 31 0 0 0 0 0 32 33 34 0 0 0 36 0 0 0 0 0 0 0 32 33 34 0 36 0 0 0 36 21 22 0
0 0 0 0 0 0 0 0 32 33 34 0 0 0 0 0 0 0 35 0 0 0 0 0 0 0 0 0 0 0 0 0 35 0 0 0 0 0 0 0 23 24 25
21 22 0 0 0 0 0 0 0 35 0 0 0 21 22 0 0 0 36 0 0 0 0 0 0 0 0 0 0 0 0 0 36 0 0 0 0 0 0 27 28 29 30
23 24 25 26 0 0 0 0 0 36 0 0 0 23 24 25 26 0 0 0 0 0 0 0 0 0 0 0 0 0 0 0 0 0 0 0 0 0 0 0 32 33 34
28 29 30 31 0 21 22 0 0 0 0 0 27 28 29 30 31 0 0 0 0 0 0 0 0 0 0 0 0 0 0 0 0 0 0 0 0 0 0 0 0 35 0
32 33 34 0 0 23 24 25 26 0 0 0 0 32 33 34 0 0 0 0 0 0 0 0 0 0 0 0 0 0 0 0 0 0 0 0 0 0 0 0 0 36 0
0 35 0 0 27 28 29 30 31 0 0 0 0 0 35 0 46 0 0 0 0 0 0 0 0 0 0 46 0 0 0 0 0 0 0 0 0 0 0 0 0 0 0
0 36 0 0 0 32 33 34 0 0 0 0 0 0 36 0 0 0 0 0 0 0 0 0 0 46 0 0 0 0 0 0 0 0 0 0 0 0 0 0 0 0 0
0 0 0 0 0 0 35 0 0 0 0 0 0 0 0 0 0 0 0 0 0 0 0 0 0 0 0 0 0 0 0 21 22 0 0 0 0 0 0 0 0 21 22
0 0 7 3 3 3 3 3 3 3 3 3 3 3 3 3 3 4 0 0 0 7 3 4 0 0 0 0 0 0 0 23 24 25 26 0 0 0 0 0 0 23 24
0 0 11 43 39 39 39 39 39 39 39 39 39 39 39 39 39 39 2 2 2 39 44 9 0 0 0 0 0 0 27 28 29 30 31 0 0 0 0 0 27 28 29
0 0 11 37 13 14 17 18 2 2 63 64 67 68 2 2 2 2 2 2 2 2 38 9 0 0 0 0 0 0 0 32 33 34 0 0 21 22 0 0 0 32 33
0 0 11 37 15 16 19 20 2 2 65 66 69 70 2 2 2 2 2 2 2 2 38 9 0 0 0 0 0 0 0 0 35 0 0 0 23 24 25 26 0 0 35
26 0 11 37 2 2 2 2 2 2 2 2 2 2 2 2 2 2 2 2 2 2 38 9 0 21 22 0 0 0 0 0 36 0 0 27 28 29 30 31 0 0 36
31 0 11 37 2 2 2 2 2 2 2 2 2 2 2 2 2 2 2 2 2 2 38 9 0 23 24 25 26 0 0 0 0 0 0 0 32 33 34 0 0 0 0
0 0 11 37 47 48 55 56 2 2 51 52 59 60 2 2 2 2 51 52 51 52 38 9 0 28 29 30 31 0 0 0 0 0 0 0 0 35 0 0 0 0 0
0 0 11 37 49 50 57 58 2 2 53 54 61 62 2 2 2 2 53 54 53 54 38 9 0 32 33 34 0 0 0 0 0 0 0 0 0 36 0 0 0 0 0
0 0 11 37 2 2 2 2 2 2 2 2 2 2 2 2 2 2 2 2 2 2 38 9 0 0 35 0 0 0 0 21 22 0 0 0 0 0 0 0 0 0 0
0 0 11 37 2 2 2 2 2 2 2 2 2 2 2 2 2 2 55 56 59 60 38 9 0 0 36 0 0 0 0 23 24 25 26 0 0 0 0 0 21 22 0
0 0 11 37 2 2 2 2 2 2 2 2 2 2 2 2 2 2 57 58 61 62 38 9 0 0 0 0 0 0 27 28 29 30 31 0 0 0 46 0 23 24 25
0 0 11 41 40 40 40 40 40 40 40 2 2 2 40 40 40 40 40 40 40 40 42 9 0 0 0 0 0 0 0 32 33 34 0 0 0 0 0 27 28 29 30
46 0 7 3 3 3 3 3 3 3 4 37 2 38 7 3 3 3 3 3 3 3 3 4 0 0 0 0 0 0 0 0 35 0 0 21 22 0 0 0 32 33 34
0 0 8 5 5 5 5 5 5 5 6 37 2 38 8 5 5 5 5 5 5 5 5 6 0 21 22 0 46 0 0 0 36 0 0 23 24 25 26 0 0 35 0
0 0 0 0 0 0 0 0 0 0 0 1 1 1 0 0 0 0 0 0 0 0 0 0 0 23 24 25 26 0 0 0 0 0 27 28 29 30 31 0 0 36 0
1 1 1 1 1 1 1 1 1 1 1 1 1 1 0 0 0 0 0 21 22 0 0 0 27 28 29 30 31 0 0 0 0 0 0 32 33 34 0 0 0 0 0
1 1 1 1 1 1 1 1 1 1 1 1 1 1 0 0 0 0 0 23 24 25 26 0 0 32 33 34 0 0 0 0 0 0 0 0 35 0 0 0 0 0 0
0 0 0 0 0 0 0 0 0 0 0 0 0 0 0 0 0 0 27 28 29 30 31 0 0 0 35 0 0 0 0 0 0 0 0 0 36 0 0 0 0 46 0