38 28
8 8 8 8 8 8 8 8 8 8 8 8 8 8 8 8 8 8 8 8 8 8 8 8 8 8 8 8 8 8 8 8 8 8 8 8 8 8
8 8 8 8 8 8 8 8 8 8 8 8 8 8 8 8 8 8 8 8 8 8 8 8 8 8 8 8 8 8 8 8 8 8 8 8 8 8
8 8 8 8 8 8 8 8 8 8 8 8 8 8 8 8 8 8 8 8 8 8 8 8 8 8 8 8 8 8 8 8 8 8 8 8 8 8
8 8 8 8 8 8 8 8 8 8 8 8 8 8 8 8 8 8 8 8 8 8 8 8 8 8 8 8 8 8 8 8 8 8 8 8 8 8
8 8 8 8 8 8 8 8 8 8 8 8 8 8 8 8 8 8 8 8 8 8 8 8 8 8 8 8 8 8 8 8 8 8 8 8 8 8
8 8 8 8 8 8 8 8 8 8 8 8 8 8 8 8 8 8 8 8 8 8 8 8 8 8 8 8 8 8 8 8 8 8 8 8 8 8
8 8 8 8 8 8 8 8 8 8 8 8 8 8 8 8 8 8 8 8 8 8 8 8 8 8 8 8 8 8 8 8 8 8 8 8 8 8
8 8 8 8 8 8 8 8 8 8 8 8 8 8 8 8 8 8 8 8 8 8 8 8 8 8 8 8 8 8 8 8 8 8 8 8 8 8
8 8 8 8 8 8 8 8 8 8 8 8 8 8 8 8 8 8 8 8 8 8 8 8 8 8 8 8 8 8 8 8 8 8 8 8 8 8
8 8 8 8 8 8 8 8 8 8 8 8 8 8 8 8 8 8 8 8 8 8 8 98 98 98 98 98 98 98 98 98 98 98 98 8 8 8
8 8 8 98 98 98 98 98 98 98 98 98 98 98 98 98 98 98 98 98 98 8 97 23 23 23 123 125 23 23 23 23 23 23 23 8 8 8
8 8 8 23 23 23 23 23 23 23 23 123 125 23 23 23 123 125 23 23 23 99 97 23 23 23 124 126 23 23 23 23 23 23 23 8 8 8
8 8 8 23 23 23 23 23 23 23 23 124 126 23 23 23 124 126 23 23 23 101 102 23 60 60 23 23 23 23 129 130 131 23 23 8 8 8
8 8 8 23 23 23 23 23 23 105 23 23 23 23 23 23 23 23 23 23 23 23 23 103 127 59 103 61 63 65 132 133 134 67 65 8 8 8
8 8 8 103 103 103 103 103 103 106 103 103 103 103 108 109 108 109 108 109 103 23 23 22 128 58 22 62 64 66 135 136 137 68 66 8 8 8
8 8 8 22 22 22 22 22 22 107 22 22 22 22 110 111 110 111 110 111 22 103 103 22 22 22 22 22 22 22 22 22 22 22 22 8 8 8
8 8 8 22 22 22 22 22 22 22 22 22 22 22 22 22 22 22 22 22 22 22 22 22 22 22 22 22 22 22 22 22 22 22 22 8 8 8
8 8 8 22 22 22 22 22 22 22 22 22 22 22 22 22 22 22 22 22 22 22 22 22 22 22 22 22 22 22 22 22 22 22 22 8 8 8
8 8 8 22 22 22 48 47 47 47 46 22 22 22 22 22 22 22 22 22 22 22 22 22 22 22 22 22 22 22 22 22 22 22 22 8 8 8
8 8 8 22 116 22 51 50 50 50 49 22 22 22 22 22 22 22 22 22 22 22 22 22 22 22 22 22 22 122 121 120 122 22 22 8 8 8
8 8 8 22 117 22 22 22 22 22 22 22 22 22 22 22 22 22 22 22 22 22 22 22 22 22 22 22 22 122 114 115 122 22 22 8 8 8
8 8 8 22 117 22 22 112 113 22 22 22 22 22 22 22 22 22 22 22 22 22 22 22 22 22 22 22 22 22 122 122 22 22 22 8 8 8
8 8 8 22 118 22 22 114 115 22 22 22 22 57 22 22 22 22 22 22 22 22 22 22 22 22 22 22 22 22 22 22 22 22 22 8 8 8
8 8 8 22 119 22 22 22 22 22 22 22 55 56 22 22 22 22 22 22 22 22 22 22 22 22 22 22 22 22 22 22 22 22 22 8 8 8
8 8 8 22 22 22 22 22 22 22 22 22 22 22 22 22 22 22 22 22 22 22 22 22 22 22 22 22 22 22 22 22 22 22 22 8 8 8
8 8 8 8 8 8 8 8 8 8 8 8 8 8 8 8 8 22 22 22 22 8 8 8 8 8 8 8 8 8 8 8 8 8 8 8 8 8
8 8 8 8 8 8 8 8 8 8 8 8 8 8 8 8 8 8 8 8 8 8 8 8 8 8 8 8 8 8 8 8 8 8 8 8 8 8
8 8 8 8 8 8 8 8 8 8 8 8 8 8 8 8 8 8 8 8 8 8 8 8 8 8 8 8 8 8 8 8 8 8 8 8 8 8