50 64
0 0 0 0 0 26 26 26 26 0 0 26 26 26 0 0 0 0 26 26 0 26 26 26 0 1 1 0 26 26 26 0 0 0 26 26 26 0 26 26 26 0 0 26 26 0 0 0 0 0
0 0 0 0 0 26 26 26 26 0 0 26 26 26 0 26 26 26 26 26 0 26 26 26 26 1 1 0 26 26 26 0 0 26 26 26 26 26 26 26 26 26 26 26 26 26 26 26 0 0
0 0 0 26 26 0 25 0 26 26 26 33 25 0 0 26 26 26 0 26 0 0 26 26 26 1 1 0 0 25 0 26 26 26 26 26 26 0 26 26 0 26 26 26 26 26 26 26 26 0
26 26 26 26 25 0 25 18 26 26 26 0 29 0 0 26 26 26 0 26 26 26 25 0 0 1 1 0 33 25 26 26 26 26 33 25 0 0 0 25 0 0 0 31 0 26 26 26 26 0
0 26 26 26 25 34 0 0 33 25 0 0 26 26 0 0 25 0 0 26 26 26 29 0 0 1 1 2 0 25 34 26 26 26 0 25 0 0 0 25 34 0 0 25 0 0 26 26 0 0
0 0 25 0 25 0 26 26 0 31 0 26 26 26 33 32 25 0 0 26 26 0 0 0 0 1 1 0 0 29 0 33 25 0 0 25 0 0 0 29 0 0 0 29 26 26 26 25 0 0
0 33 25 0 29 0 26 26 0 29 0 26 26 0 18 0 25 0 0 0 31 0 0 0 0 1 1 0 0 0 0 0 25 0 0 29 0 0 0 0 0 0 26 0 26 26 26 25 0 0
0 0 25 34 0 0 0 25 0 0 0 25 34 0 20 0 29 0 0 0 25 34 0 0 0 1 1 0 26 26 26 0 25 0 0 26 26 0 0 0 26 26 26 26 26 26 0 25 0 0
0 18 25 0 0 0 0 25 0 0 0 25 0 0 0 0 0 0 0 0 29 0 0 0 0 1 1 0 26 26 26 0 29 0 26 26 26 26 26 26 26 26 26 26 0 25 0 29 0 0
0 20 29 0 0 0 0 29 0 18 0 29 0 0 0 0 0 0 0 0 0 0 2 0 0 1 1 0 0 25 0 26 26 26 26 26 26 26 26 26 26 0 25 0 26 26 26 0 0 0
0 20 0 0 0 0 0 0 0 0 0 0 0 0 0 0 0 0 0 0 0 0 0 0 1 1 1 0 0 31 26 26 26 26 26 25 0 26 26 26 26 0 25 26 26 26 26 26 26 0
0 0 0 0 0 0 0 0 0 0 0 0 1 1 1 1 1 1 1 1 1 1 1 1 1 1 1 33 32 25 0 26 26 0 0 25 32 34 0 25 0 0 29 26 26 26 26 26 26 0
0 0 0 0 0 0 0 0 0 0 2 1 1 1 1 1 1 1 1 1 1 1 1 1 1 1 2 0 0 25 0 0 25 0 33 25 0 0 0 31 0 0 0 0 25 0 0 26 26 0
0 0 0 0 0 0 0 0 0 0 1 1 1 0 0 0 2 0 0 0 0 0 0 0 0 0 0 0 0 25 0 0 25 0 0 25 0 0 0 25 0 0 0 0 25 0 0 25 0 0
0 0 0 0 0 0 0 0 0 1 1 1 0 0 0 0 0 0 0 0 0 0 0 0 0 0 0 0 0 29 0 33 25 0 0 25 0 0 0 29 0 0 0 0 25 0 0 25 0 0
0 0 0 13 14 0 0 0 0 1 1 0 0 0 0 0 0 0 0 0 0 0 0 0 0 0 0 0 0 0 0 0 25 34 0 29 0 0 0 0 0 0 0 0 29 0 0 29 0 0
0 0 4 5 5 6 0 0 0 1 1 0 2 0 4 5 5 5 5 5 5 6 0 0 0 0 0 0 0 0 0 0 31 0 0 0 0 0 0 0 0 0 0 0 0 0 0 0 0 0
0 4 5 5 5 5 6 0 0 1 1 0 0 4 5 5 5 5 5 5 5 5 6 0 0 0 0 0 0 0 0 0 29 0 0 0 0 0 0 0 0 4 5 5 5 6 0 0 0 0
4 5 5 5 5 5 5 6 0 1 1 0 4 5 5 5 5 5 5 5 5 5 5 6 0 0 0 0 0 0 0 0 0 0 0 0 0 0 0 0 4 5 5 5 5 5 6 0 0 0
0 10 10 10 10 10 10 0 0 1 1 0 0 37 37 37 37 37 37 37 37 37 37 0 0 0 0 0 0 0 0 0 0 0 0 0 0 0 0 4 5 5 5 5 5 5 5 6 0 0
0 10 10 7 7 10 10 0 0 1 1 0 0 37 37 37 7 7 37 37 40 41 37 0 0 0 0 0 0 0 0 0 0 0 0 0 0 0 4 5 5 5 5 5 5 5 5 5 6 0
0 10 10 12 11 10 10 0 0 1 1 0 0 37 37 37 12 11 37 37 40 41 37 0 0 0 0 0 0 0 0 0 0 0 0 0 0 0 0 22 22 22 22 22 22 22 22 22 0 0
0 10 10 16 16 10 10 0 0 1 1 0 0 37 37 37 16 16 37 37 37 37 37 0 0 0 0 0 0 0 0 0 0 0 0 0 0 0 0 22 22 22 22 22 22 22 22 22 0 0
0 0 2 15 15 15 15 15 2 1 1 0 0 0 30 2 1 1 2 0 0 20 0 0 0 0 0 0 0 0 0 0 0 0 0 0 0 0 0 22 22 22 22 22 22 22 22 22 0 0
0 0 0 0 15 15 15 15 15 1 1 0 0 0 0 30 1 1 0 0 36 20 0 0 0 0 0 0 0 0 0 0 0 0 20 0 0 0 4 5 5 5 5 5 5 5 5 5 6 0
0 0 0 0 0 0 15 15 15 1 1 1 0 0 0 0 1 1 0 0 0 0 0 0 0 0 0 0 0 0 0 0 0 0 0 0 18 0 0 10 10 7 7 10 10 10 10 10 0 0
0 0 0 0 0 0 0 0 15 1 1 1 1 0 0 0 1 1 0 0 0 0 0 0 0 0 0 0 0 0 0 0 0 18 0 0 20 0 0 10 10 12 11 10 10 10 10 10 0 0
0 0 0 0 0 0 0 0 0 0 1 1 1 1 0 0 1 1 17 18 0 0 0 0 0 36 0 0 0 0 0 0 0 0 0 0 0 0 35 10 10 16 16 10 10 10 10 10 0 0
0 0 0 0 0 0 0 0 0 0 0 1 1 1 1 0 1 1 0 20 0 0 0 0 0 0 0 0 0 2 0 0 0 0 0 0 0 0 2 0 0 15 15 30 30 0 0 0 0 0
0 0 0 0 0 0 0 0 0 0 0 2 1 1 1 1 1 1 1 1 1 1 1 1 1 1 1 1 1 1 1 1 1 1 1 1 1 1 1 1 1 1 1 1 1 2 0 0 0 0
0 0 0 0 19 18 0 0 0 0 0 0 0 1 1 1 1 1 1 1 1 1 1 1 1 1 1 1 1 1 1 1 1 1 1 1 1 1 1 1 1 1 1 1 1 1 0 0 0 0
0 0 0 0 0 20 0 0 0 0 0 0 0 0 0 0 0 0 0 0 0 0 2 0 0 0 0 0 0 0 0 0 2 0 0 0 0 0 0 0 0 0 2 1 1 1 0 0 0 0
0 0 0 0 0 0 0 0 0 17 18 0 0 0 0 0 0 0 0 0 0 0 0 0 0 0 0 0 0 0 0 0 0 0 0 0 0 0 0 0 0 0 0 0 1 1 0 2 0 0
0 0 0 0 0 0 0 0 0 0 20 0 0 0 0 0 0 0 0 0 0 0 0 0 0 0 0 0 0 0 0 0 0 0 0 0 0 0 0 0 0 0 0 0 1 1 0 0 0 0
0 0 0 0 0 0 0 0 0 0 20 0 0 0 0 0 0 0 0 0 0 0 0 26 26 26 26 0 26 26 26 0 0 0 0 0 0 0 0 0 0 0 0 0 1 1 0 0 0 0
0 0 0 0 0 0 0 0 0 0 0 0 0 0 0 0 0 0 0 0 0 0 0 26 26 26 26 26 26 26 26 26 0 0 0 0 0 0 0 0 0 0 0 0 1 1 0 0 0 0
0 0 0 0 0 0 0 0 0 0 0 0 0 0 0 0 0 0 0 0 0 0 0 0 26 25 26 0 33 25 26 0 0 26 26 0 0 0 0 0 0 0 0 0 1 1 0 0 0 0
0 0 0 0 0 0 0 0 0 0 0 0 0 0 0 0 0 0 30 0 0 30 0 0 0 25 0 0 0 25 0 26 26 26 26 26 0 0 0 0 0 0 2 0 1 1 0 0 0 0
0 0 0 0 0 0 0 0 0 0 0 0 0 0 0 0 0 0 0 0 0 0 0 0 0 25 0 36 36 25 0 26 26 26 26 26 0 0 0 0 0 0 0 0 1 1 0 0 0 0
0 0 0 0 0 0 0 0 0 0 0 0 0 0 0 0 0 0 0 0 0 0 0 0 33 25 18 36 0 0 0 30 26 25 26 0 18 0 0 0 0 0 0 0 1 1 0 0 0 0
1 1 2 0 0 0 0 0 0 0 0 0 0 0 0 0 0 0 0 0 0 0 30 0 0 25 20 0 0 0 0 0 0 25 32 34 20 0 0 0 0 0 0 0 1 1 0 0 0 0
1 1 1 0 0 0 0 0 0 0 0 0 0 0 0 0 0 0 0 0 0 0 0 0 0 0 0 0 0 0 0 36 0 25 0 0 0 0 0 0 0 0 0 0 1 1 2 0 0 0
1 1 1 0 0 0 0 0 0 0 0 0 0 0 0 0 0 0 0 0 0 0 0 0 0 0 0 0 0 0 0 0 0 25 0 18 0 0 0 0 0 0 0 0 1 1 0 0 0 0
0 1 1 0 0 0 0 0 0 0 0 0 0 0 0 0 0 0 0 0 0 0 0 0 0 0 0 0 0 0 0 0 0 0 0 0 0 0 0 0 0 0 0 0 1 1 0 0 0 0
0 1 1 0 0 0 0 0 0 0 0 0 0 0 0 0 0 0 0 0 0 0 0 0 0 0 0 0 0 0 0 0 0 0 0 0 0 0 0 0 0 0 0 0 1 1 0 0 0 0
0 1 1 0 0 0 0 0 0 0 0 0 0 0 0 0 0 0 2 0 0 0 0 0 0 0 0 0 2 0 0 0 0 0 0 0 0 0 0 0 0 2 0 1 1 1 0 0 0 0
0 1 1 0 0 0 0 0 0 0 0 0 0 1 1 1 1 1 1 1 1 1 1 1 1 1 1 1 1 1 1 1 1 1 1 1 1 1 1 1 1 1 1 1 1 1 0 0 0 0
0 1 1 0 0 0 0 0 0 0 0 2 1 1 1 1 1 1 1 1 1 1 1 1 1 1 1 1 1 1 1 1 1 1 1 1 1 1 1 1 1 1 1 1 1 2 0 0 0 0
0 1 1 0 0 0 0 0 0 0 0 0 1 1 1 0 0 0 0 0 0 0 0 0 2 0 0 0 0 0 0 0 0 0 2 0 0 0 0 0 0 0 0 0 0 0 0 0 0 0
0 1 1 0 0 0 0 0 0 0 0 0 1 1 0 0 0 0 0 0 0 0 0 0 0 0 0 0 0 0 0 0 0 0 0 0 0 0 0 0 0 0 0 0 0 0 0 0 0 0
0 1 1 2 0 0 0 0 0 0 0 0 1 1 2 0 0 0 0 92 91 0 0 0 0 0 0 0 0 0 0 0 0 0 0 0 0 0 0 0 0 0 0 0 0 0 0 0 0 0
0 1 1 0 0 0 0 0 0 0 0 0 1 1 0 0 0 0 93 88 87 91 0 0 0 0 0 0 0 0 0 0 0 0 0 0 0 0 0 0 0 0 0 0 0 0 0 0 0 0
0 1 1 0 0 0 0 0 0 0 0 0 1 1 0 0 0 92 88 88 88 87 91 0 0 0 0 0 0 0 0 0 0 0 0 0 0 0 0 0 0 0 0 0 0 0 0 0 0 0
0 1 1 0 0 0 0 0 0 0 0 0 1 1 0 0 92 87 87 88 90 89 88 91 0 0 0 0 0 0 0 0 0 0 0 0 0 0 0 0 0 0 0 0 0 0 0 0 0 0
0 1 1 0 0 0 0 0 0 0 0 0 1 1 0 92 87 88 94 95 95 95 96 88 91 0 0 0 0 0 0 0 0 0 0 0 0 0 0 0 0 0 0 0 0 0 0 0 0 0
0 1 1 0 0 0 0 0 0 0 0 0 1 1 30 0 88 82 94 95 95 95 96 87 0 17 0 19 0 0 0 0 0 0 0 0 0 0 0 0 0 0 0 0 0 0 0 0 0 0
0 1 1 1 0 0 2 0 0 0 0 1 1 1 15 0 87 83 94 95 95 95 96 88 30 0 20 18 0 0 0 0 0 0 0 0 0 0 0 0 0 0 0 0 0 0 0 0 0 0
0 1 1 1 1 1 1 1 1 1 1 1 1 1 15 2 88 84 88 87 88 87 88 88 0 0 20 20 19 0 0 0 0 0 0 0 0 0 0 0 21 21 21 21 21 21 21 21 0 0
0 2 1 1 1 1 1 1 1 1 1 1 1 15 15 15 15 15 15 15 15 15 15 15 2 0 0 20 0 0 0 0 0 0 0 21 21 21 21 21 21 21 21 21 21 21 21 21 21 21
0 0 0 2 0 0 0 0 0 0 0 0 0 2 0 15 15 15 15 15 15 15 15 0 0 0 0 0 0 0 0 0 21 21 21 21 21 21 21 21 21 21 21 21 21 21 21 21 21 21
0 0 0 0 0 0 0 0 0 0 0 0 0 0 0 0 0 0 0 0 0 0 0 0 30 0 0 0 0 0 21 21 21 21 21 21 21 21 21 21 21 21 21 21 21 21 21 21 21 21
0 0 0 0 0 0 0 0 0 0 0 0 0 0 0 0 0 0 0 0 0 0 0 0 0 0 0 0 0 21 21 21 21 21 21 21 21 21 21 21 21 21 21 21 21 21 21 21 21 21
0 0 0 0 0 0 0 0 0 0 0 0 0 0 0 0 0 0 0 0 0 0 0 0 0 0 0 0 0 21 21 21 21 21 21 21 21 21 21 21 21 21 21 21 21 21 21 21 21 21
0 0 0 0 0 0 0 0 0 0 0 0 0 0 0 0 0 0 0 0 0 0 0 0 0 0 0 0 0 21 21 21 44 44 44 44 44 44 44 44 44 44 44 44 44 44 44 44 44 44