24 30
8 8 8 8 8 8 8 8 8 8 8 8 8 8 8 8 8 8 8 8 8 8 8 8
8 8 8 8 8 8 8 8 8 8 8 8 8 8 8 8 8 8 8 8 8 8 8 8
8 8 8 8 8 8 8 8 8 8 8 8 8 8 8 8 8 8 8 8 8 8 8 8
8 8 8 8 8 8 8 8 8 8 8 8 8 8 8 8 8 8 8 8 8 8 8 8
8 8 8 8 8 8 8 8 8 8 8 8 8 8 8 8 8 8 8 8 8 8 8 8
8 8 8 8 8 8 8 8 8 8 8 8 8 8 8 8 8 8 8 8 8 8 8 8
8 8 8 8 8 8 8 8 8 8 8 8 8 8 8 8 8 8 8 8 8 8 8 8
8 8 8 8 8 8 8 8 8 8 8 8 8 8 8 8 8 8 8 8 8 8 8 8
8 8 8 8 8 8 8 8 8 8 8 8 8 8 8 8 8 8 8 8 8 8 8 8
8 8 8 8 8 8 8 8 8 8 8 8 8 8 8 8 8 8 8 8 8 8 8 8
8 8 8 8 8 8 8 8 8 8 8 8 8 8 8 8 8 8 8 8 8 8 8 8
8 8 8 8 8 8 8 8 8 8 8 8 8 8 8 8 8 8 8 8 8 8 8 8
8 8 8 8 8 8 8 8 8 8 8 8 8 8 8 8 8 8 8 8 8 8 8 8
8 8 8 8 8 8 8 8 8 8 8 8 8 8 8 8 8 8 8 8 8 8 8 8
8 8 8 8 8 8 8 8 8 8 8 8 8 8 8 8 8 8 8 8 8 8 8 8
8 3 3 3 60 3 3 3 3 3 3 3 3 3 3 3 3 3 3 3 3 8 8 8
8 3 67 65 59 61 63 65 3 3 3 3 3 3 3 3 3 3 3 3 3 8 8 8
8 3 68 66 58 62 64 66 3 3 3 3 3 3 3 3 3 3 3 3 3 8 8 8
8 3 22 22 22 22 22 22 22 22 22 22 22 22 22 22 22 22 22 22 3 8 8 8
8 3 22 22 22 22 22 22 22 22 22 22 48 47 46 22 22 22 22 22 3 8 8 8
8 3 22 22 22 22 22 22 22 22 22 22 51 50 49 22 22 22 22 22 3 8 8 8
8 3 22 22 22 22 9 9 9 9 9 9 52 53 54 9 22 22 22 22 3 8 8 8
8 3 22 22 22 22 9 9 9 9 9 9 9 9 9 9 22 22 22 22 3 8 8 8
7 7 22 22 22 22 9 9 9 9 9 9 9 9 9 9 22 22 22 22 3 8 8 8
12 11 22 22 22 22 9 9 9 9 9 9 9 9 9 9 22 22 57 22 3 8 8 8
16 16 22 22 22 22 9 9 9 9 9 9 9 9 9 9 22 55 56 22 3 8 8 8
22 22 22 22 22 22 22 22 22 22 22 22 22 22 22 22 22 22 22 22 3 8 8 8
3 22 22 22 22 22 22 22 22 22 22 22 22 22 22 22 22 22 22 22 3 8 8 8
3 3 3 3 3 3 3 3 3 3 3 3 3 3 3 3 3 3 3 3 3 8 8 8
8 8 8 8 8 8 8 8 8 8 8 8 8 8 8 8 8 8 8 8 8 8 8 8