24 30
8 8 8 8 8 8 8 8 8 8 8 8 8 8 8 8 8 8 8 8 8 8 8 8
8 8 8 8 8 8 8 8 8 8 8 8 8 8 8 8 8 8 8 8 8 8 8 8
8 8 8 8 8 8 8 8 8 8 8 8 8 8 8 8 8 8 8 8 8 8 8 8
8 8 8 8 8 8 8 8 8 8 8 8 8 8 8 8 8 8 8 8 8 8 8 8
8 8 8 8 8 8 8 8 8 8 8 8 8 8 8 8 8 8 8 8 8 8 8 8
8 8 8 8 8 8 8 8 8 8 8 8 8 8 8 8 8 8 8 8 8 8 8 8
8 8 8 8 8 8 8 8 8 8 8 8 8 8 8 8 8 8 8 8 8 8 8 8
8 8 8 8 8 8 8 8 8 8 8 8 8 8 8 8 8 8 8 8 8 8 8 8
8 8 8 8 8 8 8 8 8 8 8 8 8 8 8 8 8 8 8 8 8 8 8 8
8 8 8 8 8 8 8 8 8 8 8 8 8 8 8 8 8 8 8 8 8 8 8 8
8 8 8 8 8 8 8 8 8 8 8 8 8 8 8 8 8 8 8 8 8 8 8 8
8 8 8 8 8 8 8 8 8 8 8 8 8 8 8 8 8 8 8 8 8 8 8 8
8 8 8 8 8 8 8 8 8 8 8 8 8 8 8 8 8 8 8 8 8 8 8 8
8 8 8 8 8 8 8 8 8 8 8 8 8 8 8 8 8 8 8 8 8 8 8 8
8 8 8 8 8 8 8 8 8 8 8 8 8 8 8 8 8 8 8 8 8 8 8 8
8 8 8 8 8 8 8 8 8 8 8 8 8 8 8 8 8 8 8 8 8 8 8 8
8 3 3 3 3 3 3 3 3 3 3 3 3 3 3 3 3 3 3 3 3 8 8 8
8 3 22 22 22 22 22 22 22 22 22 22 22 22 22 22 22 22 22 22 3 8 8 8
8 3 22 22 22 22 22 22 22 22 22 22 22 22 22 22 22 22 22 22 3 8 8 8
8 3 22 22 22 22 22 22 22 22 22 22 22 22 22 22 22 22 22 22 3 8 8 8
8 3 22 22 22 22 22 22 22 22 22 22 23 24 22 22 22 22 22 22 3 8 8 8
8 3 22 22 22 22 9 9 9 9 9 9 9 9 9 9 22 22 22 22 3 8 8 8
8 3 22 22 22 22 9 9 9 9 9 9 27 28 9 9 22 22 22 22 3 8 8 8
7 7 22 22 22 22 9 9 9 9 9 9 9 9 9 9 22 22 22 22 3 8 8 8
12 11 22 22 22 22 9 9 9 9 9 9 9 9 9 9 22 22 22 22 3 8 8 8
16 16 22 22 22 22 9 9 9 9 9 9 9 9 9 9 22 22 22 22 3 8 8 8
22 22 22 22 22 22 22 22 22 22 22 22 22 22 22 22 22 22 22 22 3 8 8 8
3 22 22 22 22 22 22 22 22 22 22 22 22 22 22 22 22 22 22 22 3 8 8 8
3 3 3 3 3 3 3 3 3 3 3 3 3 3 3 3 3 3 3 3 3 8 8 8
8 8 8 8 8 8 8 8 8 8 8 8 8 8 8 8 8 8 8 8 8 8 8 8