17 13
8 8 8 8 8 8 8 8 8 8 8 8 8 8 8 8 8
8 8 8 8 8 8 8 8 8 8 8 8 8 8 8 8 8
8 8 8 8 8 8 8 8 8 8 8 8 8 8 8 8 8
8 8 8 8 8 8 8 8 8 8 8 8 8 8 8 8 8
8 8 8 8 69 70 69 70 70 70 69 69 69 8 8 8 8
8 8 8 8 70 69 70 70 69 70 77 69 77 8 8 8 8
8 8 8 8 70 77 77 77 69 69 79 69 79 8 8 8 8
8 8 8 8 69 78 78 78 69 70 70 69 69 8 8 8 8
8 8 8 8 69 79 79 79 70 71 72 72 73 8 8 8 8
8 8 8 8 74 81 80 80 74 76 80 81 75 8 8 8 8
8 8 8 8 81 80 74 81 74 80 74 81 80 8 8 8 8
8 8 8 8 8 8 8 8 8 8 8 8 8 8 8 8 8
8 8 8 8 8 8 8 8 8 8 8 8 8 8 8 8 8