100 110
0 0 0 0 0 0 0 0 0 0 0 0 0 0 0 0 16 17 18 19 21 6 7 8 9 10 0 21 0 6 7 8 9 10 0 0 21 0 0 0 0 16 17 18 19 0 0 6 7 8 9 10 0 0 0 0 0 0 0 0 0 0 0 0 0 0 0 0 0 0 0 0 0 0 0 0 0 0 0 0 0 0 0 0 0 0 0 0 0 0 0 0 0 0 0 0 0 0 0 0
0 0 0 0 0 0 0 0 0 0 0 0 0 0 0 0 0 20 0 0 0 11 12 13 14 15 2 0 0 11 12 13 14 15 0 0 24 25 25 23 0 0 21 0 0 2 0 11 12 13 14 15 0 0 0 0 0 0 0 0 0 0 0 0 0 0 0 0 0 0 0 0 0 0 0 0 0 0 0 0 0 0 0 0 0 0 0 0 0 0 0 0 0 0 0 0 0 0 0 0
0 0 0 0 0 0 0 0 0 0 0 0 0 2 0 0 0 21 0 0 0 0 16 17 18 3 4 5 0 0 16 17 18 19 0 24 22 22 22 22 23 0 0 0 3 4 5 0 16 17 18 19 0 0 0 0 0 0 0 0 0 0 0 0 0 0 0 0 0 0 0 0 0 0 0 0 0 0 0 0 0 0 0 0 0 0 0 0 0 0 0 0 0 0 0 0 0 0 0 0
0 0 0 0 0 0 0 0 0 0 0 0 3 4 5 0 0 0 24 25 25 23 0 21 6 7 8 9 10 0 0 20 0 0 24 22 22 22 22 22 22 23 0 6 7 8 9 10 0 20 0 0 0 0 0 0 0 0 0 0 0 0 0 0 0 0 0 0 0 0 0 0 0 0 0 0 0 0 0 0 0 0 0 0 0 0 0 0 0 0 0 0 0 0 0 0 0 0 0 0
0 0 0 0 0 0 0 0 0 0 0 6 7 8 9 10 0 24 22 22 22 22 23 0 11 12 13 14 15 0 0 21 0 27 26 26 26 26 26 26 26 26 28 11 12 13 13 15 0 21 0 0 0 0 0 0 0 0 0 0 0 0 0 0 0 0 0 0 0 0 0 0 0 0 0 0 0 0 0 0 0 0 0 0 0 0 0 0 0 0 0 0 0 0 0 0 0 0 0 0
0 0 0 0 0 0 0 0 0 0 0 11 12 13 14 15 24 22 22 49 50 22 22 23 0 16 17 18 19 0 0 0 0 0 29 29 29 29 29 29 29 29 0 0 16 17 18 19 0 0 0 0 0 0 0 0 0 0 0 0 0 0 0 0 0 0 0 0 0 0 0 0 0 0 0 0 0 0 0 0 0 0 0 0 0 0 0 0 0 0 0 0 0 0 0 0 0 0 0 0
0 0 0 0 0 0 0 0 0 0 0 0 16 17 18 24 22 22 49 51 52 50 22 22 23 0 20 0 0 0 2 0 0 0 29 51 52 29 29 51 52 29 0 0 0 20 0 0 0 0 0 0 0 0 0 0 0 0 0 0 0 0 0 0 0 0 0 0 0 0 0 0 0 0 0 0 0 0 0 0 0 0 0 0 0 0 0 0 0 0 0 0 0 0 0 0 0 0 0 0
0 0 0 0 0 0 0 0 0 0 0 0 0 21 0 0 29 29 29 53 54 29 29 29 0 0 21 0 0 3 4 5 0 0 29 53 54 29 29 53 54 29 0 0 0 21 0 0 0 2 0 0 0 0 0 0 0 0 0 0 0 0 0 0 0 0 0 0 0 0 0 0 0 0 0 0 0 0 0 0 0 0 0 0 0 0 0 0 0 0 0 0 0 0 0 0 0 0 0 0
0 0 0 0 0 0 0 0 0 0 0 0 0 0 0 0 29 29 29 29 29 29 29 29 0 0 0 0 6 7 8 9 10 0 29 29 29 32 32 29 29 29 0 0 0 0 0 0 3 4 5 0 0 0 0 0 0 0 0 0 0 0 0 0 0 0 0 0 0 0 0 0 0 0 0 0 0 0 0 0 0 0 0 0 0 0 0 0 0 0 0 0 0 0 0 0 0 0 0 0
0 0 0 0 0 0 0 0 0 0 0 0 0 0 0 0 55 56 55 56 29 29 29 29 0 0 0 0 11 12 13 14 15 0 29 29 29 34 33 29 29 29 0 0 0 0 0 6 7 8 9 10 0 0 0 0 0 0 0 0 0 0 0 0 0 0 0 0 0 0 0 0 0 0 0 0 0 0 0 0 0 0 0 0 0 0 0 0 0 0 0 0 0 0 0 0 0 0 0 0
0 0 0 0 0 0 0 0 0 0 0 0 0 0 0 0 53 54 53 54 29 29 29 29 0 0 0 0 0 16 17 18 19 0 29 29 29 35 35 29 29 29 0 0 2 0 0 11 12 13 14 15 0 0 0 0 0 0 0 0 0 0 0 0 0 0 0 0 0 0 0 0 0 0 0 0 0 0 0 0 0 0 0 0 0 0 0 0 0 0 0 0 0 0 0 0 0 0 0 0
0 0 0 0 0 0 0 0 0 0 0 0 0 0 0 0 29 29 29 29 29 32 32 29 0 0 0 0 0 0 20 0 0 0 0 0 0 63 61 0 0 0 0 3 4 5 0 0 16 17 18 19 0 0 0 0 0 0 0 0 0 0 0 0 0 0 0 0 0 0 0 0 0 0 0 0 0 0 0 0 0 0 0 0 0 0 0 0 0 0 0 0 0 0 0 0 0 0 0 0
0 0 0 0 0 0 0 0 0 0 0 0 0 0 0 0 29 29 29 29 29 34 33 29 0 0 0 2 0 0 21 0 0 2 0 0 0 63 61 0 0 0 6 7 8 9 10 0 0 21 0 0 0 0 0 0 0 0 0 0 0 0 0 0 0 0 0 0 0 0 0 0 0 0 0 0 0 0 0 0 0 0 0 0 0 0 0 0 0 0 0 0 0 0 0 0 0 0 0 0
0 0 0 0 0 0 0 0 0 0 0 0 0 0 0 0 29 29 29 29 29 35 35 29 36 0 3 4 5 0 0 0 3 4 5 0 0 63 61 0 0 0 11 12 13 14 15 0 0 0 0 0 0 0 0 0 0 0 0 0 0 0 0 0 0 0 0 0 0 0 0 0 0 0 0 0 0 0 0 0 0 0 0 0 0 0 0 0 0 0 0 0 0 0 0 0 0 0 0 0
0 0 0 0 0 0 0 0 0 0 0 0 0 0 0 0 0 0 0 0 0 63 61 0 0 6 7 8 9 10 0 6 7 8 9 10 0 63 61 0 0 0 0 16 17 18 19 0 0 0 0 0 0 0 0 0 0 0 0 0 0 0 0 0 0 0 0 0 0 0 0 0 0 0 0 0 0 0 0 0 0 0 0 0 0 0 0 0 0 0 0 0 0 0 0 0 0 0 0 0
0 0 0 0 0 0 0 0 0 0 0 0 0 0 0 0 0 0 0 0 0 63 61 0 0 11 12 13 14 15 0 11 12 13 14 15 0 63 61 0 0 0 0 0 20 0 0 0 0 0 0 0 0 0 0 0 0 0 0 0 0 0 0 0 0 0 0 0 0 0 0 0 0 0 0 0 0 0 0 0 0 0 0 0 0 0 0 0 0 0 0 0 0 0 0 0 0 0 0 0
0 0 0 0 0 0 0 0 0 0 0 0 0 0 0 0 0 0 0 0 0 63 61 0 0 0 16 17 18 19 0 0 16 17 18 19 0 63 61 0 0 0 0 0 21 0 0 0 0 0 0 0 0 0 0 0 0 0 0 0 0 0 0 0 0 0 0 0 0 0 0 0 0 0 0 0 0 0 0 0 0 0 0 0 0 0 0 0 0 0 0 0 0 0 0 0 0 0 0 0
0 0 0 0 0 0 0 0 0 0 0 0 0 0 0 0 0 0 0 0 67 1 66 0 0 0 0 21 0 0 0 0 0 21 0 0 0 63 61 0 0 0 0 0 0 0 0 0 0 0 0 0 0 0 0 0 0 0 0 0 0 0 0 0 0 0 0 0 0 0 0 0 0 0 0 0 0 0 0 0 0 0 0 0 0 0 0 0 0 0 0 0 0 0 0 0 0 0 0 0
0 0 0 0 0 0 0 0 0 0 0 0 0 0 0 0 0 0 0 0 63 61 0 0 0 0 0 0 0 0 0 0 0 0 0 0 36 63 61 0 0 0 0 0 0 0 0 0 0 0 0 0 0 0 0 0 0 0 0 0 0 0 0 0 0 0 0 0 0 0 0 0 0 0 0 0 0 0 0 0 0 0 0 0 0 0 0 0 0 0 0 0 0 0 0 0 0 0 0 0
0 0 0 0 0 0 0 0 0 0 0 0 0 0 0 0 0 0 0 0 63 1 62 62 62 62 62 62 62 62 62 62 62 62 62 62 62 1 1 68 0 0 0 0 0 0 0 0 0 0 0 0 0 0 0 0 0 0 0 0 0 0 0 0 0 0 0 0 0 0 0 0 0 0 0 0 0 0 0 0 0 0 0 0 0 0 0 0 0 0 0 0 0 0 0 0 0 0 0 0
0 0 0 0 0 0 0 0 0 0 0 0 0 0 0 0 0 0 0 0 63 1 64 64 64 64 64 64 64 64 64 64 64 64 64 64 64 64 1 61 0 0 0 0 0 0 0 0 0 0 0 0 0 0 0 0 0 0 0 0 0 0 0 0 0 0 0 0 0 0 0 0 0 0 0 0 0 0 0 0 0 0 0 0 0 0 0 0 0 0 0 0 0 0 0 0 0 0 0 0
0 0 0 0 0 0 0 0 0 0 0 0 0 0 0 0 0 0 0 0 63 61 0 0 0 0 0 0 0 0 0 0 0 0 0 0 0 0 63 61 0 0 0 0 0 0 0 0 0 0 0 0 0 0 0 0 0 0 0 0 0 0 0 0 0 0 0 0 0 0 0 0 0 0 0 0 0 0 0 0 0 0 0 0 0 0 0 0 0 0 0 0 0 0 0 0 0 0 0 0
0 0 0 0 0 0 0 0 0 0 0 0 0 0 0 0 0 0 0 0 63 1 62 68 0 0 0 0 0 0 0 0 0 0 0 0 0 0 63 61 0 0 0 0 0 0 0 0 0 0 0 0 0 0 0 0 0 0 0 0 0 0 0 0 0 0 0 0 0 0 0 0 0 0 0 0 0 0 0 0 0 0 0 0 0 0 0 0 0 0 0 0 0 0 0 0 0 0 0 0
0 0 0 0 0 0 0 0 0 0 0 0 0 0 0 0 0 0 0 0 65 64 1 61 0 0 0 0 0 0 0 0 0 0 0 0 0 0 63 61 0 0 0 0 0 0 0 0 0 0 0 0 0 0 0 0 0 0 0 0 0 0 0 0 0 0 0 0 0 0 0 0 0 0 0 0 0 0 0 0 0 0 0 0 0 0 0 0 0 0 0 0 0 0 0 0 0 0 0 0
0 0 0 0 0 0 0 0 0 0 0 0 0 0 0 0 0 0 0 0 0 0 63 61 0 0 0 0 0 0 0 0 0 0 0 0 0 0 63 61 0 0 0 0 0 0 0 0 0 0 0 0 0 0 0 0 0 0 0 0 0 0 0 0 0 0 0 0 0 0 0 0 0 0 0 0 0 0 0 0 0 0 0 0 0 0 0 0 0 0 0 0 0 0 0 0 0 0 0 0
0 0 0 0 0 0 0 0 0 0 0 0 0 0 0 0 0 0 0 0 0 0 63 61 0 0 0 0 0 0 0 0 0 0 0 0 0 0 63 61 0 0 0 0 0 0 0 0 0 0 0 0 0 0 0 0 0 0 0 0 0 0 0 0 0 0 0 0 0 0 0 0 0 0 0 0 0 0 0 0 0 0 0 0 0 0 0 0 0 0 0 0 0 0 0 0 0 0 0 0
0 96 96 96 101 0 0 0 0 0 0 0 0 0 0 0 0 0 0 0 0 0 63 61 0 0 0 0 0 0 0 0 0 0 0 0 0 0 63 61 0 0 0 0 0 0 0 0 0 0 0 0 0 0 0 0 0 0 0 0 0 0 0 0 0 0 0 0 0 0 0 0 0 0 0 0 0 0 0 0 0 0 0 0 0 0 0 0 0 0 0 0 0 0 0 0 0 0 0 0
0 0 0 0 102 0 0 0 0 58 58 58 58 58 58 58 58 58 58 58 58 58 58 58 58 58 58 58 58 58 58 58 58 58 58 58 58 58 58 58 58 58 58 58 58 58 58 58 58 58 58 58 58 58 58 58 58 58 58 58 58 58 58 58 58 58 58 58 58 58 58 58 58 58 58 58 58 58 58 58 58 58 58 58 58 58 58 58 58 58 58 58 58 58 58 0 0 0 0 0
0 0 0 0 102 0 0 0 0 58 100 96 96 96 96 96 96 96 96 96 96 96 96 96 96 96 96 96 96 96 96 96 96 96 96 96 96 96 96 96 96 96 96 96 96 96 96 96 96 96 96 96 96 96 96 96 96 96 96 96 96 96 96 96 96 96 96 96 96 96 96 96 96 96 96 96 96 96 96 96 96 96 96 96 96 96 96 96 96 96 96 96 96 96 58 0 0 0 0 0
0 0 0 0 102 0 0 0 0 58 103 30 97 97 97 97 97 97 97 97 97 97 97 97 97 97 97 97 97 97 97 97 97 97 97 97 97 97 97 97 97 97 97 97 97 97 97 30 30 97 97 97 97 97 97 97 97 97 97 97 97 97 97 97 97 97 97 97 97 97 97 97 97 97 97 97 97 97 97 97 97 97 97 97 97 97 97 97 30 30 97 97 97 99 58 0 0 0 0 0
0 0 0 0 102 0 0 0 0 58 103 102 58 58 58 58 58 58 58 58 58 58 58 58 58 58 58 58 58 58 58 58 58 58 58 58 58 58 58 58 58 58 58 58 58 58 58 103 102 58 58 58 58 58 58 58 58 58 58 58 58 58 58 58 58 58 58 58 58 58 58 58 58 58 58 58 58 58 58 58 58 58 58 58 58 58 58 58 103 102 58 58 58 58 58 0 0 0 0 0
0 0 0 0 102 0 0 0 0 58 103 102 58 0 0 0 0 0 0 0 0 0 0 0 0 0 0 0 0 0 0 0 0 0 0 0 0 0 0 0 0 0 0 0 0 0 58 103 102 58 0 0 0 0 0 0 0 0 0 0 0 0 0 0 0 0 0 0 0 0 0 0 0 0 0 0 0 0 0 0 0 0 0 0 0 0 0 58 103 102 58 0 0 0 0 0 0 0 0 0
0 0 0 0 102 0 0 0 0 58 103 102 58 0 0 0 0 92 92 92 92 92 92 92 92 92 92 92 92 92 92 92 92 92 92 92 92 92 92 92 92 0 0 0 0 0 58 103 102 58 0 0 0 0 0 0 0 0 0 0 0 0 0 0 0 0 0 0 0 0 0 0 0 0 0 0 0 0 0 0 0 0 0 0 0 0 0 58 103 102 58 0 0 0 0 0 0 0 0 0
0 0 0 0 102 0 0 0 0 58 103 102 58 0 0 0 0 92 92 92 92 92 92 92 92 92 92 92 92 92 92 92 92 92 92 92 92 92 92 92 92 0 0 0 0 0 58 103 102 58 0 0 0 0 0 0 0 0 0 0 0 0 0 0 0 0 0 0 0 0 0 0 0 0 0 0 0 0 0 0 0 0 0 0 0 0 0 58 103 102 58 0 0 0 0 0 0 0 0 0
0 0 0 0 102 0 0 0 0 58 103 102 58 0 0 0 0 89 94 95 90 90 90 90 90 90 90 90 90 90 90 90 90 90 90 90 90 90 90 90 91 0 0 0 0 0 58 103 102 58 0 0 0 0 0 0 0 72 80 80 80 73 0 0 0 0 0 0 0 0 0 0 0 0 0 0 0 43 44 0 0 0 0 0 0 0 0 58 103 102 58 0 0 0 0 0 0 0 0 0
0 0 0 0 102 0 0 0 0 58 103 102 58 0 0 0 0 89 93 93 93 90 93 93 93 90 90 93 93 93 90 93 93 93 90 90 93 93 93 90 91 0 0 0 0 0 58 103 102 58 0 0 0 0 0 0 72 80 80 80 80 80 73 0 0 0 0 0 0 0 0 0 0 0 0 0 43 42 42 44 0 0 0 0 0 0 0 58 103 102 58 0 0 0 0 0 0 0 0 0
0 0 0 0 0 0 0 0 0 58 103 102 58 0 0 0 0 89 93 93 93 90 93 93 93 90 90 93 93 93 90 93 93 93 90 90 93 93 93 90 91 0 0 0 0 0 58 103 102 58 0 0 0 0 0 72 80 80 80 80 80 80 80 73 0 0 0 0 0 0 0 0 0 0 0 45 42 42 42 42 44 0 0 0 0 0 0 58 103 102 58 0 0 0 0 0 0 0 0 0
0 0 0 0 0 0 0 0 0 58 103 102 58 0 0 0 0 89 93 93 93 90 93 93 93 90 90 93 93 93 90 93 93 93 90 90 93 93 93 90 91 0 0 0 0 0 58 103 102 58 0 0 0 0 72 80 80 80 80 80 80 80 80 80 73 0 0 0 0 0 0 0 0 0 43 42 42 42 37 42 42 44 0 0 0 0 0 58 103 102 58 0 0 0 0 0 0 0 0 0
0 0 0 0 0 0 0 0 0 58 103 102 58 0 0 0 0 89 90 90 90 90 90 90 90 90 90 90 90 90 90 90 90 90 90 90 90 90 90 90 91 0 0 0 0 0 58 103 102 58 0 0 0 72 80 80 80 80 78 79 77 80 80 79 76 73 0 0 0 0 0 0 0 43 42 42 42 42 42 42 42 42 44 0 0 0 0 58 103 102 58 0 0 0 0 0 0 0 0 0
0 0 0 0 0 0 0 0 0 58 103 102 58 0 0 0 0 89 90 86 87 90 90 90 90 90 86 87 90 90 90 90 90 90 86 87 90 90 90 90 91 0 0 0 0 0 58 103 102 58 0 0 0 69 81 82 70 74 76 76 76 75 70 81 82 71 0 0 0 0 0 0 0 0 37 37 37 37 37 37 37 37 0 0 0 0 0 58 103 102 58 0 0 0 0 0 0 0 0 0
0 0 0 0 0 0 0 0 0 58 103 102 58 0 0 0 0 0 0 0 0 0 0 0 0 0 0 0 0 0 0 0 0 0 0 0 0 0 0 0 0 0 0 0 0 0 58 103 102 58 0 0 0 69 83 84 70 69 70 70 70 71 70 83 84 71 0 0 0 0 0 0 0 0 42 37 37 46 48 48 47 37 0 0 0 0 0 58 103 102 58 0 0 0 0 0 0 0 0 0
0 0 0 0 0 0 0 0 0 58 103 102 58 0 0 0 0 0 0 0 0 0 0 0 0 0 0 0 0 0 0 0 0 0 0 0 0 0 0 0 0 0 0 0 0 0 58 103 102 58 0 0 0 69 70 70 70 69 70 70 70 71 70 70 70 71 0 0 0 0 0 0 0 0 37 37 37 46 48 48 47 37 0 0 0 0 0 58 103 102 58 0 0 0 0 0 0 0 0 0
0 0 0 0 0 0 0 0 0 58 103 102 58 0 0 0 0 0 0 0 0 0 0 0 0 0 0 0 0 0 0 0 0 0 0 0 0 0 0 0 0 0 0 0 0 0 58 103 102 58 0 0 0 69 81 82 70 69 85 85 70 71 70 81 82 71 0 0 0 0 0 0 0 0 37 40 42 46 48 48 47 37 0 0 0 0 0 58 103 102 58 0 0 0 0 0 0 0 0 0
0 0 0 0 0 0 0 0 0 58 103 102 58 0 0 0 0 0 0 0 0 0 0 0 0 0 0 0 0 0 0 0 0 0 0 0 0 0 0 0 0 0 0 0 0 0 58 103 102 58 0 0 0 69 83 84 70 69 86 87 70 71 70 83 84 71 0 0 0 0 0 0 0 0 37 39 37 46 48 48 47 37 0 0 0 0 0 58 103 102 58 0 0 0 0 0 0 0 0 0
0 0 0 0 0 0 0 0 0 58 103 102 58 0 0 0 0 0 0 0 0 0 0 0 0 0 0 0 0 0 0 0 0 0 0 0 0 0 0 0 0 0 0 0 0 0 58 103 102 58 0 0 36 69 70 70 70 69 88 88 70 71 70 70 70 71 0 0 0 0 0 0 0 36 37 38 37 37 37 37 37 37 0 0 0 0 0 58 103 102 58 0 0 0 0 0 0 0 0 0
0 0 0 0 0 0 0 0 0 58 103 102 58 0 0 0 0 0 0 0 0 0 0 0 0 0 0 0 0 0 0 0 0 0 0 0 0 0 0 0 0 0 0 0 0 0 58 103 102 58 0 0 0 0 0 0 0 0 0 0 0 0 0 0 0 0 0 0 0 0 0 0 0 0 0 0 0 0 0 0 0 0 0 0 0 0 0 58 103 102 58 0 0 0 0 0 0 0 0 0
0 0 0 0 0 0 0 0 0 58 103 102 58 0 0 0 0 0 0 0 0 0 0 0 0 0 0 0 0 0 0 0 0 0 0 0 0 0 0 0 0 0 0 0 0 0 58 103 102 58 0 0 0 0 0 0 0 0 0 0 0 0 0 0 0 0 0 0 0 0 0 0 0 0 0 0 0 0 0 0 0 0 0 0 0 0 0 58 103 102 58 0 0 0 0 0 0 0 0 0
0 0 0 0 0 0 0 0 0 58 103 102 58 0 0 0 0 0 0 0 0 0 0 0 0 0 0 0 0 0 0 0 0 0 0 0 0 0 0 0 0 0 0 0 0 0 58 103 102 58 0 0 0 0 0 0 0 0 0 0 0 0 0 0 0 0 0 0 0 0 0 0 0 0 0 0 0 0 0 0 0 0 0 0 0 0 0 58 103 102 58 0 0 0 0 0 0 0 0 0
0 0 0 0 0 0 0 0 0 58 103 102 58 0 0 0 0 0 0 0 0 0 0 0 0 0 0 0 0 0 0 0 0 0 0 0 0 0 0 0 0 0 0 0 0 0 58 103 102 58 0 0 0 92 92 92 92 92 92 92 0 0 0 0 0 92 92 92 92 92 92 92 0 0 72 79 79 73 0 0 92 92 92 92 92 0 0 58 103 102 58 0 0 0 0 0 0 0 0 0
0 0 0 0 0 0 0 0 0 58 103 102 58 0 0 0 0 0 0 0 0 0 0 0 0 0 0 0 0 0 0 0 0 0 0 0 0 0 0 0 0 0 0 0 0 0 58 103 102 58 0 0 0 92 92 92 92 92 92 92 0 0 0 0 0 92 92 92 92 92 92 92 0 72 80 80 80 80 73 0 92 92 92 92 92 0 0 58 103 102 58 0 0 0 0 0 0 0 0 0
0 0 0 0 0 0 0 0 0 58 103 102 58 0 0 0 0 0 0 0 0 0 0 0 0 0 0 0 0 0 0 0 0 0 0 0 0 0 0 0 0 0 0 0 0 0 58 103 102 58 0 0 0 69 70 70 70 70 70 71 0 0 0 0 0 105 106 106 106 106 106 107 0 105 106 106 106 106 107 0 105 106 106 106 107 0 0 58 103 102 58 0 0 0 0 0 0 0 0 0
0 0 0 0 0 0 0 0 0 58 103 102 58 0 0 0 0 0 0 0 0 0 0 0 0 0 0 0 0 0 0 0 0 0 0 0 0 0 0 0 0 0 0 0 0 0 58 103 102 58 0 0 0 69 81 82 70 70 70 71 92 92 92 0 0 105 106 106 106 106 106 107 0 105 106 106 106 106 107 0 105 106 106 106 107 0 0 58 103 102 58 0 0 0 0 0 0 0 0 0
0 0 0 0 0 0 0 0 0 58 103 102 58 0 0 0 0 0 0 0 0 0 0 0 0 0 0 0 0 0 0 0 0 0 0 0 0 0 0 0 0 0 0 0 0 0 58 103 102 58 0 0 0 69 83 84 70 70 70 71 70 70 71 0 0 105 106 106 106 106 106 107 0 105 106 106 106 106 107 0 105 106 106 106 107 0 0 58 103 102 58 0 0 0 0 0 0 0 0 0
58 58 58 58 58 58 58 58 58 58 103 102 58 0 0 0 0 0 0 0 0 0 0 0 0 0 0 0 0 0 0 0 0 0 0 0 0 0 0 0 0 0 0 0 0 0 58 103 102 58 0 0 0 69 70 70 70 70 70 71 70 85 71 0 0 105 106 106 106 106 106 107 0 105 106 106 106 106 107 0 105 106 106 106 107 0 0 58 103 102 58 0 0 0 0 0 0 0 0 0
96 96 96 96 96 96 96 96 96 96 30 102 58 0 0 0 0 0 0 0 0 0 0 0 0 0 0 0 0 0 0 0 0 0 0 0 0 0 0 0 0 0 0 0 0 0 58 103 102 58 0 0 0 69 70 70 85 85 70 71 70 87 71 0 0 105 106 106 106 106 106 107 0 105 106 106 106 106 107 0 105 106 106 106 107 0 0 58 103 102 58 0 0 0 0 0 0 0 0 0
97 97 97 97 97 97 97 97 97 97 30 102 58 0 0 0 0 0 0 0 0 0 0 0 0 0 0 0 0 0 0 0 0 0 0 0 0 0 0 0 0 0 0 0 0 0 58 103 102 58 0 0 0 69 70 70 86 87 70 71 0 0 0 0 0 105 106 106 106 106 106 107 0 105 106 106 106 106 107 0 105 106 106 106 107 0 0 58 103 102 58 0 0 0 0 0 0 0 0 0
58 58 58 58 58 58 58 58 58 58 103 102 58 0 0 0 0 0 0 0 0 0 0 0 0 0 0 0 0 0 0 0 0 0 0 0 0 0 0 0 0 0 0 0 0 0 58 103 102 58 0 0 0 69 70 70 88 88 70 71 0 0 0 0 0 105 106 106 106 106 106 107 0 105 106 106 106 106 107 0 105 106 106 106 107 0 0 58 103 102 58 0 0 0 0 0 0 0 0 0
0 0 0 0 0 0 0 0 0 58 103 102 58 0 0 0 0 0 0 0 0 0 0 0 0 0 0 0 0 0 0 0 0 0 0 0 0 0 0 0 0 0 0 0 0 0 58 103 102 58 0 0 0 0 0 0 0 0 0 0 0 0 0 0 0 0 0 0 0 0 0 0 0 0 0 0 0 0 0 0 0 0 0 0 0 0 0 58 103 102 58 0 0 0 0 0 0 0 0 0
0 0 0 0 0 0 0 0 0 58 103 102 58 0 0 0 0 0 0 0 0 0 0 0 0 0 0 0 29 29 29 29 0 0 0 0 0 0 0 0 0 0 0 0 0 0 58 103 102 58 0 0 0 0 0 0 0 0 0 0 0 0 0 0 0 0 0 0 0 0 0 0 0 0 0 0 0 0 0 0 0 0 0 0 0 0 0 58 103 102 58 0 0 0 0 0 0 0 0 0
0 0 0 0 0 0 0 0 0 58 103 102 58 0 0 0 0 0 0 0 0 0 0 0 0 0 0 0 29 29 29 29 0 0 0 0 0 0 0 0 0 0 0 0 0 0 58 103 102 58 0 0 0 0 0 0 0 0 0 0 0 0 0 0 0 0 0 0 0 0 0 0 0 0 0 0 0 0 0 0 0 0 0 0 0 0 0 58 103 102 58 0 0 0 0 0 0 0 0 0
0 0 0 0 0 0 0 0 0 58 103 102 58 0 0 0 0 0 0 0 0 0 0 0 0 0 29 29 29 29 29 29 29 29 0 0 0 0 0 0 0 0 0 0 0 0 58 103 102 58 0 0 0 0 0 0 0 0 0 0 0 0 0 0 0 0 0 0 0 0 0 0 0 0 0 0 0 0 0 0 0 0 0 0 0 0 0 58 103 102 58 0 0 0 0 0 0 0 0 0
0 0 0 0 0 0 0 0 0 58 103 102 58 0 0 0 29 29 29 29 29 29 29 29 0 0 29 29 29 29 29 29 29 29 0 0 0 0 0 0 0 0 0 0 0 0 58 103 102 58 0 0 0 0 0 0 0 0 0 0 0 0 0 0 0 0 0 0 0 0 0 0 0 0 0 0 0 0 0 0 0 0 0 0 0 0 0 58 103 102 58 0 0 0 0 0 0 0 0 0
0 0 0 0 0 0 0 0 0 58 103 102 58 0 0 0 29 29 29 29 29 29 29 29 0 0 29 29 29 29 29 29 29 29 0 0 0 0 0 0 0 0 0 0 0 0 58 103 102 58 0 0 0 0 0 0 0 0 0 0 0 0 0 0 0 0 0 0 0 0 0 0 0 0 0 0 0 0 0 0 0 0 0 0 0 0 0 58 103 102 58 0 0 0 0 0 0 0 0 0
0 0 0 0 0 0 0 0 0 58 103 102 58 0 0 0 29 29 29 29 29 29 29 29 0 0 29 29 29 29 29 29 29 29 0 0 0 0 0 0 0 0 0 0 0 0 58 103 102 58 0 0 0 0 0 0 0 0 0 0 0 0 0 0 0 0 0 0 0 0 0 0 0 0 0 0 0 0 0 0 0 0 0 0 0 0 0 58 103 102 58 0 0 0 0 0 0 0 0 0
0 0 0 0 0 0 0 0 0 58 103 102 58 0 0 0 29 29 29 29 29 29 29 29 0 0 29 29 29 29 29 29 29 29 0 0 0 0 0 0 0 0 0 0 0 0 58 103 102 58 0 0 0 0 0 0 0 0 0 0 0 0 0 0 0 0 0 0 0 0 0 0 0 0 0 0 0 0 0 0 0 0 0 0 0 0 0 58 103 102 58 0 0 0 0 0 0 0 0 0
0 0 0 0 0 0 0 0 0 58 103 102 58 0 0 0 29 29 29 29 29 29 29 29 0 0 29 29 29 29 29 29 29 29 0 0 0 0 0 0 0 0 0 0 0 0 58 103 102 58 0 0 0 0 0 0 0 0 0 0 0 0 0 0 0 0 0 0 0 0 0 0 0 0 0 0 0 0 0 0 0 0 0 0 0 0 0 58 103 102 58 0 0 0 0 0 0 0 0 0
0 0 0 0 0 0 0 0 0 58 103 102 58 0 0 0 29 29 29 29 29 29 29 29 0 0 29 29 29 29 29 29 29 29 0 0 0 0 0 0 0 0 0 0 0 0 58 103 102 58 0 0 0 0 0 0 0 0 0 0 0 0 0 0 0 0 0 0 0 0 0 0 0 0 0 0 0 0 0 0 0 0 0 0 0 0 0 0 103 102 58 0 0 0 0 0 0 0 0 0
0 0 0 0 0 0 0 0 0 58 103 102 58 0 0 0 29 29 29 29 29 29 29 29 0 0 29 29 29 29 29 29 29 29 0 0 0 0 0 0 0 0 0 0 0 0 58 103 102 58 0 0 0 0 0 0 0 0 0 0 0 0 0 0 0 0 0 0 0 0 0 0 0 0 0 0 0 0 0 0 0 0 0 0 0 0 0 0 103 102 58 0 0 0 0 0 0 0 0 0
0 0 0 0 0 0 0 0 0 58 103 30 96 96 96 96 96 96 96 96 96 96 96 96 96 96 96 96 96 96 96 96 96 96 96 96 96 96 96 96 96 96 96 96 96 96 96 30 30 96 96 96 96 96 96 96 96 96 96 96 96 96 96 96 96 96 96 96 96 96 96 96 96 96 96 96 96 96 96 96 96 96 96 96 96 96 96 96 97 99 58 0 0 0 0 0 0 0 0 0
0 0 0 0 0 0 0 0 0 58 103 30 97 97 97 97 97 97 97 97 97 97 97 97 97 97 97 97 97 97 97 97 97 97 97 97 97 97 97 97 97 97 97 97 97 97 97 30 30 97 97 97 97 97 97 97 97 97 97 97 97 97 97 97 97 97 97 97 97 97 97 97 30 102 58 58 58 58 58 58 58 58 58 58 58 58 58 58 58 58 58 0 0 0 0 0 0 0 0 0
0 0 0 0 0 0 0 0 0 58 103 102 58 0 0 0 29 29 29 29 29 29 29 29 0 0 29 29 29 29 29 29 29 29 0 0 0 0 0 0 0 0 0 0 0 0 58 103 102 58 0 0 0 0 0 0 0 0 0 0 0 0 0 0 0 0 0 0 0 0 0 58 103 102 58 0 0 0 0 0 0 0 0 0 0 0 0 0 0 0 0 0 0 0 0 0 0 0 0 0
0 0 0 0 0 0 0 0 0 58 103 102 58 0 0 0 29 29 29 29 29 29 29 29 0 0 29 29 29 29 29 29 29 29 0 0 0 0 0 0 0 0 0 0 0 0 58 103 102 58 0 0 0 0 0 0 0 0 0 0 0 0 0 0 0 0 0 0 0 0 0 58 103 102 58 0 0 0 0 0 0 0 0 0 0 0 0 0 0 0 0 0 0 0 0 0 0 0 0 0
0 0 0 0 0 0 0 0 0 58 103 102 58 0 0 0 0 0 0 0 0 0 0 0 0 0 0 0 0 0 0 0 0 0 0 0 0 0 0 0 0 0 0 0 0 0 58 103 102 58 0 0 0 0 0 0 0 0 0 0 0 0 0 0 0 0 0 0 0 0 0 58 103 102 58 0 0 0 0 0 0 0 0 0 0 0 0 0 0 0 0 0 0 0 0 0 0 0 0 0
0 0 0 0 0 0 0 0 0 58 103 102 58 0 0 0 0 0 0 0 0 0 0 0 0 0 0 0 0 0 0 0 0 0 0 0 0 0 0 0 0 0 0 0 0 0 58 103 102 58 0 0 0 0 0 0 0 0 0 0 0 0 0 0 0 0 0 0 0 0 0 58 103 102 58 0 0 0 0 0 0 0 0 0 0 0 0 0 0 0 0 0 0 0 0 0 0 0 0 0
0 0 0 0 0 0 0 0 0 58 103 102 58 0 0 0 0 0 0 0 0 0 0 0 0 0 0 0 0 0 0 0 0 0 0 0 0 0 0 0 0 0 0 0 0 0 58 103 102 58 0 0 0 0 0 0 0 0 0 0 0 0 0 0 0 0 0 0 0 0 0 58 103 102 58 0 0 0 0 0 0 0 0 0 0 0 0 0 0 0 0 0 0 0 0 0 0 0 0 0
0 0 0 0 0 0 0 0 0 58 103 102 58 0 0 0 0 0 0 0 0 0 0 0 0 0 0 0 0 0 0 0 0 0 0 0 0 0 0 0 0 0 0 0 0 0 58 103 102 58 0 0 0 0 0 0 0 0 0 0 0 0 0 0 0 0 0 0 0 0 0 58 103 102 58 0 0 0 0 0 0 0 0 0 0 0 0 0 0 0 0 0 0 0 0 0 0 0 0 0
0 0 0 0 0 0 0 0 0 58 103 102 58 0 0 0 29 29 29 29 29 29 29 29 29 29 29 29 29 29 29 29 29 29 29 29 29 29 29 29 29 29 29 0 0 0 58 103 102 58 0 0 0 0 0 0 0 0 0 0 0 0 0 0 0 0 0 0 0 0 0 58 103 102 58 0 0 0 0 0 0 0 0 0 0 0 0 0 0 0 0 0 0 0 0 0 0 0 0 0
0 0 0 0 0 0 0 0 0 58 103 102 58 0 0 0 29 29 29 29 29 29 29 29 29 29 29 29 29 29 29 29 29 29 29 29 29 29 29 29 29 29 29 0 0 0 58 103 102 58 0 0 0 0 0 0 0 0 0 0 0 0 0 0 0 0 0 0 0 0 0 58 103 102 58 0 0 0 0 0 0 0 0 0 0 0 0 0 0 0 0 0 0 0 0 0 0 0 0 0
0 0 0 0 0 0 0 0 0 58 103 102 58 0 0 0 29 29 29 29 29 29 29 29 29 29 29 29 29 29 29 29 29 29 29 29 29 29 29 29 29 29 29 0 0 0 58 103 102 58 0 0 0 0 0 0 0 0 0 0 0 0 0 0 0 0 0 0 0 0 0 58 103 102 58 0 0 129 125 125 125 125 125 125 125 125 125 125 125 125 125 125 125 125 125 125 125 125 126 0
58 58 58 58 58 58 58 58 58 58 103 102 58 0 0 0 29 29 29 29 29 29 29 29 29 29 29 29 29 29 29 29 29 29 29 29 29 29 29 29 29 29 29 0 0 0 58 103 102 58 0 0 0 0 0 0 0 0 0 0 0 0 0 0 0 0 0 0 0 0 0 58 103 102 58 0 0 133 0 0 0 0 0 0 0 0 0 0 0 0 0 0 0 0 0 0 0 0 131 0
96 96 96 96 96 96 96 96 96 96 30 102 58 0 0 0 29 29 29 29 29 29 29 29 29 29 29 29 29 29 29 29 29 29 29 29 29 29 29 29 29 29 29 0 0 0 58 103 102 58 0 0 0 0 0 0 0 0 0 0 0 0 0 0 0 0 0 0 0 0 0 58 103 102 58 0 0 133 0 0 0 0 0 0 0 0 0 0 0 0 0 0 143 144 0 0 0 0 131 0
97 97 97 97 97 97 97 97 97 97 30 102 58 0 0 0 29 29 29 29 29 29 29 29 29 29 29 29 29 29 29 29 29 29 29 29 29 29 29 29 29 29 29 0 0 0 58 103 102 58 0 0 0 0 0 0 0 0 0 0 0 0 0 0 0 0 0 0 0 0 0 58 103 102 58 0 0 133 0 0 135 136 0 0 0 0 0 0 0 0 0 0 145 146 0 0 0 0 131 0
58 58 58 58 58 58 58 58 58 58 103 102 58 0 0 0 29 29 29 29 29 29 29 29 29 29 29 29 29 29 29 29 29 29 29 29 29 29 29 29 29 29 29 0 0 0 58 103 102 58 0 0 0 0 0 0 0 0 0 0 0 0 0 0 0 0 0 0 0 0 0 58 103 102 58 0 0 133 0 0 137 138 0 0 0 0 0 0 0 0 0 0 0 0 0 0 0 0 131 0
0 0 0 0 0 0 0 0 0 58 103 102 58 0 0 0 29 29 29 29 29 29 29 29 29 29 29 29 29 29 29 29 29 29 29 29 29 29 29 29 29 29 29 0 0 0 58 103 102 58 0 0 0 0 0 0 0 0 0 0 0 0 0 0 0 0 0 0 0 0 0 58 103 102 58 0 0 133 0 0 0 0 0 139 140 0 0 0 0 0 0 0 0 0 0 135 136 0 131 0
0 0 0 0 0 0 0 0 0 58 103 102 58 0 0 0 29 29 29 29 29 29 29 29 29 29 29 29 29 29 29 29 29 29 29 29 29 29 29 29 29 29 29 0 0 0 58 103 102 58 0 0 0 0 0 0 0 0 0 0 0 0 0 0 0 0 0 0 0 0 0 58 103 102 58 0 0 133 0 0 0 0 0 141 142 0 0 0 0 0 0 0 0 0 0 137 138 0 131 0
0 0 0 0 0 0 0 0 0 58 103 102 58 0 0 0 29 29 29 29 29 29 29 29 29 29 29 29 29 29 29 29 29 29 29 29 29 29 29 29 29 29 29 0 0 0 58 103 102 58 0 0 0 0 0 0 0 0 0 0 0 0 0 0 0 0 0 0 0 0 0 58 103 102 58 0 0 133 0 0 0 0 0 0 0 0 0 0 0 0 0 139 140 0 0 0 0 0 131 0
0 0 0 0 0 0 0 0 0 58 103 102 58 0 0 0 0 0 0 0 0 0 0 0 0 0 0 0 0 0 0 0 0 0 0 0 0 0 0 0 0 0 0 0 0 0 58 103 102 58 0 0 0 0 0 0 0 0 0 0 0 0 0 0 0 0 0 0 0 0 0 58 103 102 58 0 0 133 0 135 136 0 0 0 0 0 0 0 0 0 0 141 142 0 0 0 0 0 131 0
0 0 0 0 0 0 0 0 0 58 103 102 58 0 0 0 0 0 0 0 0 0 0 0 0 0 0 0 0 0 0 0 0 0 0 0 0 0 0 0 0 0 0 0 0 0 58 103 102 58 0 0 0 0 0 0 0 0 0 0 0 0 0 0 0 0 0 0 0 0 0 58 103 102 58 0 0 133 0 137 138 0 0 143 144 0 0 0 0 0 0 0 0 0 143 144 0 0 131 0
0 0 0 0 0 0 0 0 0 58 103 102 58 0 0 0 0 0 0 0 0 0 0 0 0 0 0 0 0 0 0 0 0 0 0 0 0 0 0 0 0 0 0 0 0 0 58 103 102 58 0 0 0 0 0 0 0 0 0 0 0 0 0 0 0 0 0 0 0 0 0 58 103 102 58 0 0 133 0 0 0 0 0 145 146 0 0 0 0 0 0 0 0 0 145 146 0 0 131 0
0 0 0 0 0 0 0 0 0 58 103 102 58 0 0 0 0 0 0 0 0 0 0 0 0 0 0 0 0 0 0 0 0 0 0 0 0 0 0 0 0 0 0 0 0 0 58 103 102 58 0 0 0 0 0 0 0 0 0 0 0 0 0 0 0 0 0 0 0 0 0 58 103 102 58 0 0 133 0 0 0 0 0 0 0 0 0 0 0 0 0 0 0 0 0 0 0 0 131 0
0 0 0 0 0 0 0 0 0 58 103 102 58 0 0 0 0 0 0 0 0 0 0 0 0 0 0 0 0 0 0 0 0 0 0 0 0 0 0 0 0 0 0 0 0 0 58 103 102 58 0 0 0 0 0 0 0 0 0 0 0 0 0 0 0 0 0 0 0 0 0 58 103 102 58 0 0 133 0 0 0 0 0 0 0 0 0 0 0 0 0 135 136 0 0 0 0 0 131 0
0 0 0 0 0 0 0 0 0 58 103 102 58 0 0 29 29 29 29 29 29 29 29 29 29 29 29 29 29 29 0 0 0 0 0 0 0 0 0 0 29 29 29 29 29 0 58 103 102 58 0 0 0 0 0 0 0 0 0 0 0 0 0 0 0 0 0 0 0 0 0 58 103 102 58 0 0 133 0 135 136 0 0 0 0 0 0 0 0 0 0 137 138 0 0 0 0 0 131 0
0 0 0 0 0 0 0 0 0 58 103 102 58 0 0 29 29 29 29 29 29 29 29 29 29 29 29 29 29 29 0 0 0 0 0 0 0 0 0 0 29 29 29 29 29 0 58 103 102 58 0 0 0 0 0 0 0 0 0 0 0 0 0 0 0 0 0 0 0 0 0 58 103 102 58 0 0 133 0 137 138 0 0 139 140 0 0 0 0 0 0 0 0 0 0 0 0 0 131 0
0 0 0 0 0 0 0 0 0 58 103 102 58 0 0 29 29 29 29 29 29 29 29 29 29 29 29 29 29 29 0 0 0 0 0 0 29 29 29 29 29 29 29 29 29 0 58 103 102 58 0 0 0 0 0 0 0 0 0 0 0 0 0 0 0 0 0 0 0 0 0 58 103 102 58 0 0 133 0 0 0 0 0 141 142 0 0 0 0 0 0 0 0 0 143 144 0 0 131 0
0 0 0 0 0 0 0 0 0 58 103 102 58 0 0 29 29 29 29 29 29 29 29 0 0 0 0 0 0 0 0 0 0 0 0 0 29 29 29 29 29 29 29 29 29 0 58 103 102 58 0 0 0 0 0 0 0 0 0 0 0 0 0 0 0 0 0 0 0 0 0 58 103 102 58 0 0 133 0 0 0 0 0 0 0 0 0 0 0 0 0 0 0 0 145 146 0 0 131 0
0 0 0 0 0 0 0 0 0 58 103 102 58 0 0 29 29 29 29 29 29 29 29 0 0 0 0 0 0 0 0 0 0 0 0 0 29 29 29 29 29 29 29 29 29 0 58 103 102 58 0 0 0 0 0 0 0 0 0 0 0 0 0 0 0 0 0 0 0 0 0 58 103 102 58 0 0 133 0 143 144 0 0 0 0 0 0 0 0 0 0 0 0 0 0 0 0 0 131 0
0 0 0 0 0 0 0 0 0 58 103 102 58 0 0 29 29 29 29 29 29 29 29 0 0 0 0 0 0 0 0 0 0 0 0 0 29 29 29 29 29 29 29 29 29 0 58 103 102 58 0 0 0 0 0 0 0 0 0 0 0 0 0 0 0 0 0 0 0 0 0 58 103 102 58 0 0 133 0 145 146 0 0 0 0 0 0 0 0 0 0 0 0 0 0 0 0 0 131 0
0 0 0 0 0 0 0 0 0 58 103 102 58 0 0 0 0 0 0 0 0 0 0 0 0 0 0 0 0 0 0 0 0 0 0 0 0 0 0 0 0 0 0 0 0 0 58 103 102 58 0 0 0 0 0 0 0 0 0 0 0 0 0 0 0 0 0 0 0 0 0 58 103 102 58 0 0 133 0 0 0 0 0 0 0 0 0 0 0 0 0 0 0 0 0 0 0 0 131 0
0 0 0 0 0 0 0 0 0 58 103 102 58 0 0 0 0 0 0 0 0 0 0 0 0 0 0 0 0 0 0 0 0 0 0 0 0 0 0 0 0 0 0 0 0 0 58 103 102 58 0 0 0 0 0 0 0 0 0 0 0 0 0 0 0 0 0 0 0 0 0 58 103 102 58 0 0 133 0 0 0 0 0 0 0 0 0 0 0 0 0 0 0 0 0 0 0 0 131 0
0 0 0 0 0 0 0 0 0 58 103 102 58 58 58 58 58 58 58 58 58 58 58 58 58 58 58 58 58 58 58 58 58 58 58 58 58 58 58 58 58 58 58 58 58 58 58 103 102 58 58 58 58 58 58 58 58 58 58 58 58 58 58 58 58 58 58 58 58 58 58 58 103 102 58 0 0 133 0 0 0 0 0 0 0 0 0 0 0 0 0 0 0 0 0 0 0 0 131 0
0 0 0 0 0 0 0 0 0 58 103 30 96 96 96 96 96 96 96 96 96 96 96 96 96 96 96 96 96 96 96 96 96 96 96 96 96 96 96 96 96 96 96 96 96 96 96 30 30 96 96 96 96 96 96 96 96 96 96 96 96 96 96 96 96 96 96 96 96 96 96 96 30 102 58 0 0 129 126 125 126 125 126 125 126 125 126 0 0 129 126 125 126 125 126 125 126 125 126 0
0 0 0 0 0 0 0 0 0 58 98 97 97 97 97 97 97 97 97 97 97 97 97 97 97 97 97 97 97 97 97 97 97 97 97 97 97 97 97 97 97 97 97 97 97 97 97 97 97 97 97 97 97 97 97 97 97 97 97 97 97 97 97 97 97 97 97 97 97 97 97 97 97 99 58 0 0 130 128 127 128 127 128 127 128 127 128 0 0 130 128 127 128 127 128 127 128 127 128 0
0 0 0 0 0 0 0 0 0 58 58 58 58 58 58 58 58 58 58 58 58 58 58 58 58 58 58 58 58 58 58 58 58 58 58 58 58 58 58 58 58 58 58 58 58 58 58 58 58 58 58 58 58 58 58 58 58 58 58 58 58 58 58 58 58 58 58 58 58 58 58 58 58 58 58 0 0 0 0 0 0 0 0 0 0 0 0 0 0 0 0 0 0 0 0 0 0 0 0 0
0 0 0 0 0 0 0 0 0 0 0 0 0 0 0 0 0 0 0 0 0 0 0 0 0 0 0 0 0 0 0 0 0 0 0 0 0 0 0 0 0 0 0 0 0 0 0 0 0 0 0 0 0 0 0 0 0 0 0 0 0 0 0 0 0 0 0 0 0 0 0 0 0 0 0 0 0 0 0 0 0 0 0 0 0 0 0 0 0 0 0 0 0 0 0 0 0 0 0 0
0 0 0 0 0 0 0 0 0 0 0 0 0 0 0 0 0 0 0 0 0 0 0 0 0 0 0 0 0 0 0 0 0 0 0 0 0 0 0 0 0 0 0 0 0 0 0 0 0 0 0 0 0 0 0 0 0 0 0 0 0 0 0 0 0 0 0 0 0 0 0 0 0 0 0 0 0 0 0 0 0 0 0 0 0 0 0 0 0 0 0 0 0 0 0 0 0 0 0 0
0 0 0 0 0 0 0 0 0 0 0 0 0 0 0 0 0 0 0 0 0 0 0 0 0 0 0 0 0 0 0 0 0 0 0 0 0 0 0 0 0 0 0 0 0 0 0 0 0 0 0 0 0 0 0 0 0 0 0 0 0 0 0 0 0 0 0 0 0 0 0 0 0 0 0 0 0 0 0 0 0 0 0 0 0 0 0 0 0 0 0 0 0 0 0 0 0 0 0 0
0 0 0 0 0 0 0 0 0 0 0 0 0 0 0 0 0 0 0 0 0 0 0 0 0 0 0 0 0 0 0 0 0 0 0 0 0 0 0 0 0 0 0 0 0 0 0 0 0 0 0 0 0 0 0 0 0 0 0 0 0 0 0 0 0 0 0 0 0 0 0 0 0 0 0 0 0 0 0 0 0 0 0 0 0 0 0 0 0 0 0 0 0 0 0 0 0 0 0 0
0 0 0 0 0 0 0 0 0 0 0 0 0 0 0 0 0 0 0 0 0 0 0 0 0 0 0 0 0 0 0 0 0 0 0 0 0 0 0 0 0 0 0 0 0 0 0 0 0 0 0 0 0 0 0 0 0 0 0 0 0 0 0 0 0 0 0 0 0 0 0 0 0 0 0 0 0 0 0 0 0 0 0 0 0 0 0 0 0 0 0 0 0 0 0 0 0 0 0 0
0 0 0 0 0 0 0 0 0 0 0 0 0 0 0 0 0 0 0 0 0 0 0 0 0 0 0 0 0 0 0 0 0 0 0 0 0 0 0 0 0 0 0 0 0 0 0 0 0 0 0 0 0 0 0 0 0 0 0 0 0 0 0 0 0 0 0 0 0 0 0 0 0 0 0 0 0 0 0 0 0 0 0 0 0 0 0 0 0 0 0 0 0 0 0 0 0 0 0 0
0 0 0 0 0 0 0 0 0 0 0 0 0 0 0 0 0 0 0 0 0 0 0 0 0 0 0 0 0 0 0 0 0 0 0 0 0 0 0 0 0 0 0 0 0 0 0 0 0 0 0 0 0 0 0 0 0 0 0 0 0 0 0 0 0 0 0 0 0 0 0 0 0 0 0 0 0 0 0 0 0 0 0 0 0 0 0 0 0 0 0 0 0 0 0 0 0 0 0 0