50 64
0 0 16 17 18 19 0 20 0 2 0 16 17 18 0 2 0 0 16 17 18 0 21 0 24 25 25 23 0 21 0 0 0 16 17 18 0 0 11 12 13 14 15 21 16 17 18 0 0 0
0 0 0 20 0 0 0 21 3 4 5 0 20 0 3 4 5 0 0 20 0 0 0 24 22 22 22 22 23 0 0 0 0 0 21 0 0 2 0 16 17 18 0 0 0 20 0 2 0 0
0 0 2 20 0 0 0 6 7 8 9 10 21 6 7 8 9 10 0 21 0 0 27 26 26 26 26 26 26 28 0 0 2 0 0 0 3 4 5 0 20 0 0 0 0 20 3 4 5 0
0 3 4 5 0 0 0 11 12 13 14 15 0 11 12 13 14 15 0 0 0 0 29 29 29 29 29 29 29 29 0 3 4 5 0 6 7 8 9 10 21 0 0 0 0 21 7 8 9 10
6 7 8 9 10 0 2 0 16 17 18 19 0 2 16 17 18 0 2 0 0 0 55 56 29 29 29 29 184 29 6 7 8 9 10 11 12 13 14 15 0 0 0 0 0 11 12 13 14 15
11 12 13 14 15 3 4 5 0 20 0 0 3 4 5 20 0 3 4 5 0 0 53 54 29 32 32 29 29 29 11 12 13 14 15 0 16 17 18 0 0 2 0 0 0 0 16 17 18 0
0 16 17 18 6 7 8 9 10 21 0 6 7 8 9 15 6 7 8 9 10 0 29 29 29 34 33 29 29 29 0 16 17 18 0 0 0 20 0 0 3 4 5 0 0 0 0 20 0 0
0 0 20 0 11 12 13 14 15 0 0 11 12 13 14 15 11 13 13 14 15 0 29 29 29 35 35 29 29 29 0 0 20 0 0 2 0 20 0 6 7 8 9 10 0 2 0 21 0 0
0 0 21 0 0 16 17 18 19 0 2 0 16 17 18 19 0 16 17 18 0 0 0 0 0 63 61 0 0 0 0 0 21 0 3 4 5 21 0 11 12 13 14 15 3 4 5 0 0 0
0 0 0 0 0 0 20 0 0 3 4 5 0 21 0 0 0 0 21 0 0 0 0 0 0 63 61 0 0 0 0 0 0 6 7 8 9 10 0 0 16 17 18 6 7 8 9 10 0 0
0 0 0 0 0 0 21 0 6 7 8 9 10 0 0 0 0 0 0 0 0 0 0 0 36 63 61 0 0 0 2 0 0 11 12 13 14 15 0 0 0 20 0 11 12 13 14 15 0 0
0 0 0 0 0 0 0 0 11 12 13 14 15 0 2 0 0 0 63 62 62 62 62 62 62 1 66 0 0 3 4 5 0 0 16 17 18 0 0 2 0 21 0 0 16 17 18 0 0 0
0 0 24 25 25 25 25 23 0 16 17 18 0 3 4 5 0 0 63 1 1 64 64 64 64 66 31 0 6 7 8 9 10 0 0 20 0 0 3 4 5 0 0 0 0 20 0 2 0 0
0 24 22 22 49 50 22 22 23 0 20 0 6 7 8 9 10 0 63 1 61 0 0 0 0 0 0 0 11 12 13 14 15 0 0 21 0 6 7 8 9 10 0 0 0 21 3 4 5 0
27 26 26 49 51 52 50 26 26 28 21 0 11 12 13 14 15 0 63 1 61 0 0 0 0 0 2 0 0 16 17 18 0 0 2 0 0 11 12 13 14 15 0 0 0 6 7 8 9 10
0 29 29 29 53 54 29 29 57 0 0 0 0 16 17 18 0 0 63 1 61 0 0 0 0 3 4 5 0 0 21 0 0 3 4 5 0 0 16 17 18 0 0 0 0 11 12 13 14 15
0 29 55 56 29 29 55 56 57 0 0 2 0 0 21 0 0 0 63 1 61 0 0 0 6 7 8 9 10 0 0 0 6 7 8 9 10 0 0 20 0 0 0 0 0 0 16 17 18 0
0 29 53 54 29 29 53 54 57 0 3 4 5 0 0 0 0 0 63 1 61 0 0 0 11 12 13 13 15 0 0 0 11 12 13 14 15 0 0 21 0 24 25 25 25 25 23 21 0 0
0 29 29 29 32 32 29 29 57 6 7 8 9 10 0 0 0 0 63 1 61 0 0 0 0 16 17 18 0 0 2 0 0 16 17 18 0 0 0 0 24 22 22 22 22 22 22 23 0 0
0 29 29 29 34 33 29 29 57 11 12 13 14 15 0 2 0 0 63 1 61 0 0 2 0 0 21 0 0 3 4 5 0 0 20 0 0 0 0 27 26 26 26 26 26 26 26 26 28 0
0 29 29 29 35 35 29 29 57 0 16 17 18 0 3 4 5 0 63 1 61 0 3 4 5 0 0 0 6 7 8 9 10 0 21 0 0 0 0 29 29 29 29 29 29 29 29 29 29 0
0 0 63 1 1 61 0 0 0 0 0 21 0 6 7 8 9 10 63 1 61 6 7 8 9 10 0 0 11 12 13 14 15 0 0 0 0 0 0 29 29 29 29 55 56 55 56 55 56 0
0 0 63 1 1 61 0 0 0 0 0 0 0 11 12 13 14 15 63 1 61 11 12 13 14 15 0 2 0 16 17 18 0 0 2 0 0 0 0 29 32 32 29 53 54 53 54 53 54 0
0 0 63 1 1 61 36 0 0 0 0 0 0 0 16 17 18 0 63 1 61 0 16 17 18 0 3 4 5 0 20 0 0 3 4 5 0 0 0 29 34 33 29 29 29 29 29 29 29 0
0 0 63 1 1 1 62 62 62 62 62 0 0 0 0 20 0 0 63 1 61 0 0 21 0 6 7 8 9 10 20 0 6 7 8 9 10 0 0 29 35 35 29 29 29 29 29 29 29 0
0 0 63 1 1 1 1 1 1 1 1 62 0 0 0 21 0 0 63 1 61 0 0 0 0 11 12 13 14 15 21 0 11 12 13 14 15 0 0 0 30 30 0 0 0 0 0 0 0 0
0 0 65 64 64 64 64 64 64 64 1 1 62 0 0 0 0 0 63 1 61 0 0 0 0 0 16 17 18 0 0 0 0 16 17 18 0 0 0 0 30 30 0 0 0 0 0 2 0 0
0 0 0 0 0 0 0 0 0 0 64 1 1 62 0 0 0 0 63 1 61 0 0 0 0 0 0 21 0 0 0 0 0 0 21 0 0 0 0 0 30 30 0 0 0 0 3 4 5 0
0 0 0 0 0 0 0 0 0 0 0 64 1 1 62 0 0 0 63 1 61 0 0 0 0 0 0 0 0 31 0 0 0 0 0 0 0 0 0 0 30 30 36 0 0 6 7 8 9 10
0 0 0 0 0 0 0 0 0 0 0 31 64 1 1 62 62 62 1 1 1 62 62 62 62 62 62 62 62 62 62 62 62 62 62 62 62 62 62 62 62 62 62 62 62 61 16 17 18 0
0 0 0 0 0 0 0 0 0 0 0 0 0 63 1 1 1 1 1 1 1 1 1 1 1 1 1 1 1 1 1 1 1 1 1 1 1 1 1 1 1 1 1 1 1 61 0 20 0 0
0 0 0 0 0 0 0 0 0 0 0 0 0 65 64 64 64 64 64 64 64 64 64 64 64 64 64 64 64 64 64 64 64 64 64 64 64 64 64 64 64 64 64 1 1 61 0 21 0 0
0 0 0 0 0 0 0 0 0 0 0 0 0 0 0 0 0 0 0 0 0 0 0 0 0 0 0 0 0 0 0 0 0 0 0 0 31 0 0 0 0 0 0 63 1 61 0 0 0 0
0 0 0 0 0 0 0 0 0 0 0 0 0 0 0 0 0 0 0 0 0 0 0 0 0 0 0 0 0 0 0 0 0 0 0 0 0 0 0 0 0 0 0 63 1 61 0 0 0 0
0 0 0 0 0 0 0 0 0 0 0 0 0 0 0 0 0 0 0 0 0 0 0 0 0 0 0 0 0 0 0 0 0 0 0 0 0 0 0 0 0 0 0 63 1 61 0 0 0 0
0 0 0 0 0 0 0 0 0 0 0 0 0 0 0 0 0 0 0 0 0 0 0 0 0 0 0 0 0 0 0 0 0 0 0 0 0 0 0 0 0 0 0 63 1 61 0 0 0 0
0 0 0 0 0 0 0 0 0 0 0 0 0 0 0 0 0 0 0 0 0 0 0 0 0 0 0 0 0 0 0 0 0 0 0 0 0 0 0 0 0 0 0 63 1 61 0 0 0 0
0 0 0 0 0 0 0 0 0 0 0 0 0 0 0 0 0 0 0 0 0 0 0 0 0 0 0 0 0 0 0 0 0 0 0 0 0 0 0 0 0 0 0 63 1 61 0 0 0 0
0 0 0 0 0 0 0 0 0 0 0 0 0 0 0 0 0 0 0 0 0 0 0 0 0 0 0 0 0 0 0 0 0 0 0 0 0 0 0 0 0 0 0 63 1 61 0 0 0 0
0 0 0 0 0 0 0 0 0 0 0 0 0 0 0 0 0 0 0 0 0 0 0 0 0 0 0 0 0 0 0 0 0 0 0 0 0 0 0 0 0 0 0 63 1 61 0 0 0 0
62 62 62 62 0 0 0 0 0 0 0 0 0 0 0 0 0 0 0 0 0 0 0 0 0 0 0 0 0 0 0 0 0 0 0 0 0 0 0 0 0 0 0 63 1 61 0 0 0 0
1 1 1 61 0 0 0 0 0 0 0 0 0 0 0 0 0 0 0 0 0 0 0 0 0 0 0 0 0 0 0 0 0 0 0 0 0 0 0 0 0 0 0 63 1 61 31 0 0 0
64 1 1 61 0 0 0 0 0 0 0 0 0 0 0 0 0 0 0 0 0 0 0 0 0 0 0 0 0 0 0 0 0 0 0 0 0 0 0 0 0 0 0 63 1 61 0 0 0 0
0 63 1 61 0 0 0 0 0 0 0 0 0 0 0 0 0 0 0 0 0 0 0 0 0 0 0 0 0 0 0 0 0 0 0 0 0 0 0 0 0 0 0 63 1 61 0 0 0 0
0 63 1 61 0 0 0 0 0 0 0 0 0 0 0 62 0 0 0 0 0 0 0 0 0 0 0 0 0 0 0 0 0 0 0 0 0 0 0 0 0 0 0 63 1 61 0 0 0 0
0 63 1 61 0 0 0 0 0 0 0 62 62 62 62 62 62 62 62 62 62 62 62 62 62 62 62 62 62 62 62 62 62 62 62 62 62 62 62 62 62 62 62 62 1 61 0 0 0 0
0 63 1 61 0 0 0 0 0 0 0 63 1 1 1 1 1 1 64 64 1 1 1 1 1 1 1 1 1 1 1 1 1 1 1 1 1 1 1 1 1 1 1 1 1 61 0 0 0 0
0 63 1 61 0 0 0 0 0 0 0 63 1 1 64 64 64 64 64 64 64 64 64 64 64 64 64 64 64 64 64 64 64 64 64 64 64 64 64 64 64 64 64 64 64 66 0 0 0 0
0 63 1 61 0 0 0 0 0 0 0 63 1 61 0 0 0 0 0 0 0 0 0 0 31 0 0 0 0 0 0 0 0 0 31 0 0 0 0 0 0 0 0 0 0 0 0 0 0 0
0 63 1 61 0 0 0 0 0 0 0 63 1 61 0 0 0 0 0 0 0 0 0 0 0 0 0 0 0 0 0 0 0 0 0 0 0 0 0 0 0 0 0 0 0 0 0 0 0 0
0 63 1 61 0 0 0 0 0 0 0 63 1 61 31 0 0 0 0 43 44 0 0 0 0 0 0 0 0 0 0 0 0 0 0 0 0 0 0 0 0 0 0 0 0 0 0 0 0 0
0 63 1 61 0 0 0 0 0 0 0 63 1 61 0 0 0 0 45 42 37 44 0 0 0 0 0 0 0 0 0 0 0 0 0 0 0 0 0 0 0 0 0 0 0 0 0 0 0 0
0 63 1 61 0 0 0 0 0 0 0 63 1 61 0 0 0 43 37 37 37 37 44 0 0 0 0 0 0 0 0 0 0 0 0 0 0 0 0 0 0 0 0 0 0 0 0 0 0 0
0 63 1 61 0 0 0 0 0 0 0 63 1 61 0 0 43 37 37 37 37 37 42 44 0 0 0 0 0 0 0 0 0 0 0 0 0 0 0 0 0 0 0 0 0 0 0 0 0 0
0 63 1 61 0 0 0 0 0 0 0 63 1 61 0 43 37 37 46 48 48 48 47 42 44 0 0 0 0 0 0 0 0 0 0 0 0 0 0 0 0 0 0 0 0 0 0 0 0 0
0 63 1 61 0 0 0 0 0 0 0 63 1 61 0 0 37 40 46 48 48 48 47 37 0 0 0 0 0 0 0 0 0 0 0 0 0 0 0 0 0 0 0 0 0 0 0 0 0 0
0 63 1 61 0 0 31 0 0 0 0 63 1 61 0 0 37 39 46 48 48 48 47 37 0 0 0 0 0 0 0 0 0 0 0 0 0 0 0 0 0 0 0 0 0 0 0 0 0 0
0 63 1 1 62 62 62 62 62 62 62 1 1 61 0 36 37 38 37 37 37 37 37 37 0 0 0 0 0 0 0 0 0 0 0 0 0 0 0 0 0 0 0 0 0 0 0 0 0 0
0 65 1 1 1 1 1 1 1 1 1 1 1 61 0 30 30 30 30 30 30 30 30 30 31 0 0 0 0 0 0 0 0 0 0 0 0 0 0 0 0 0 0 0 0 0 0 0 0 0
0 31 63 1 1 1 1 1 1 1 1 1 1 1 62 30 30 30 30 30 30 30 30 30 0 0 0 0 0 0 0 0 0 0 0 0 0 0 0 0 0 0 0 0 0 0 0 0 0 0
0 0 65 64 64 64 64 64 64 64 64 64 64 64 64 30 30 30 30 30 30 30 30 30 0 0 0 0 0 0 0 0 0 0 0 0 0 0 0 0 0 0 0 0 0 0 0 0 0 0
0 0 0 0 0 0 0 0 0 0 0 0 0 0 0 0 0 0 0 0 0 0 0 0 0 0 0 0 0 0 0 0 0 0 0 0 0 0 0 0 0 0 0 0 0 0 0 0 0 0
0 0 0 0 0 0 0 0 0 0 0 0 0 0 0 0 0 0 0 0 0 0 0 0 0 0 0 0 0 0 0 0 0 0 0 0 0 0 0 0 0 0 0 0 0 0 0 0 0 0
0 0 0 0 0 0 0 0 0 0 0 0 0 0 0 0 0 0 0 0 0 0 0 0 0 0 0 0 0 0 0 0 0 0 0 0 0 0 0 0 0 0 0 0 0 0 0 0 0 0