91 79
0 0 0 0 0 0 0 0 0 0 16 17 18 19 21 6 7 8 9 10 0 21 0 6 7 8 9 10 0 0 21 0 0 0 0 16 17 18 19 0 0 6 7 8 9 10 0 0 0 0 0 0 0 0 0 119 120 121 0 0 0 0 0 0 0 123 0 0 0 0 0 0 0 0 0 0 0 123 0 0 0 0 122 0 0 0 0 0 0 0 0
0 0 0 0 0 0 0 0 0 0 0 20 0 0 0 11 12 13 14 15 2 0 0 11 12 13 14 15 0 0 24 25 25 23 0 0 21 0 0 2 0 11 12 13 14 15 0 0 0 0 0 0 0 0 0 0 122 0 0 0 0 0 0 0 0 0 0 0 0 0 0 108 109 0 0 0 0 0 0 0 0 0 123 0 0 0 0 0 0 0 0
0 0 0 0 0 0 0 2 0 0 0 21 0 0 0 0 16 17 18 3 4 5 0 0 16 17 18 19 0 24 26 26 26 26 23 0 0 0 3 4 5 0 16 17 18 19 0 0 108 109 0 0 0 0 0 0 123 0 0 0 0 0 0 0 0 0 0 0 0 0 0 110 111 112 113 0 0 0 0 0 0 0 0 0 0 0 0 0 0 0 0
0 0 0 0 0 0 3 4 5 0 0 0 24 25 25 23 0 21 6 7 8 9 10 0 0 20 0 0 24 26 26 26 26 26 26 23 0 6 7 8 9 10 0 20 0 0 0 0 110 111 112 113 0 0 0 0 0 0 0 0 0 0 0 108 109 0 0 0 0 0 114 115 116 117 118 0 0 0 0 0 0 0 0 0 0 0 0 0 0 0 0
0 0 0 0 0 6 7 8 9 10 0 24 26 26 26 26 23 0 11 12 13 14 15 0 0 21 0 24 26 26 26 26 26 26 26 26 28 11 12 13 13 15 0 21 0 0 0 114 115 116 117 118 0 0 0 0 0 0 0 0 0 0 0 110 111 112 113 0 0 0 0 119 120 121 0 0 0 0 0 108 109 0 0 0 0 0 0 0 0 0 0
0 0 0 0 0 11 12 13 14 15 24 26 26 49 50 26 26 23 0 16 17 18 19 0 0 0 0 0 29 29 29 29 29 29 29 29 0 0 16 17 18 19 0 0 0 0 0 0 119 120 121 0 0 0 0 0 108 109 0 0 0 0 114 115 116 117 118 0 0 0 0 0 122 0 0 0 0 0 0 110 111 112 113 0 0 0 0 0 0 0 0
0 0 0 0 0 0 16 17 18 24 26 26 49 51 52 50 26 26 23 0 20 0 0 0 2 0 0 0 29 51 52 29 29 51 52 29 0 0 0 20 0 0 0 0 0 0 0 0 0 122 0 0 0 0 0 0 110 111 112 113 0 0 0 119 120 121 0 0 0 0 0 0 123 0 0 0 0 0 114 115 116 117 118 0 0 0 0 0 0 0 0
0 0 2 0 0 0 0 21 0 0 29 29 29 53 54 29 29 29 0 0 21 0 0 3 4 5 0 0 29 53 54 29 29 53 54 29 0 0 0 21 0 0 0 2 0 0 0 0 0 123 0 0 0 0 0 114 115 116 117 118 0 0 0 0 122 0 0 0 0 0 0 0 0 0 0 0 0 0 0 119 120 121 0 0 0 0 0 0 0 0 0
0 3 4 5 0 0 0 0 0 0 29 29 29 29 29 29 29 29 0 0 0 0 6 7 8 9 10 0 29 29 29 32 32 29 29 29 0 0 0 0 0 0 3 4 5 0 0 0 0 0 0 0 0 0 0 0 119 120 121 0 0 0 0 0 123 0 0 0 0 0 0 0 0 0 0 0 0 0 0 0 122 0 0 0 0 0 0 0 0 114 115
6 7 8 9 10 0 0 0 0 0 55 56 55 56 29 192 193 29 0 0 0 0 11 12 13 14 15 0 29 29 29 34 33 29 29 29 0 0 0 0 0 6 7 8 9 10 0 0 0 0 0 0 0 0 0 0 0 122 0 0 0 0 0 0 0 0 0 0 0 0 0 0 0 0 0 0 0 0 0 0 123 0 0 0 0 0 0 0 0 0 0
11 12 13 14 15 0 2 0 0 0 53 54 53 54 29 29 29 29 0 0 0 0 0 16 17 18 19 0 29 29 29 35 35 29 29 29 0 0 0 0 0 11 12 13 14 15 0 0 0 0 0 0 0 0 0 0 0 123 0 0 0 0 0 0 0 0 0 0 0 0 0 0 0 108 109 0 0 0 0 0 0 0 0 0 0 0 0 0 0 0 0
0 16 17 18 19 3 4 5 0 0 29 29 29 29 29 32 32 29 0 0 0 0 0 0 20 0 0 0 0 0 0 63 61 0 0 0 0 0 0 0 0 0 16 17 18 19 0 0 0 0 0 2 0 0 0 0 0 0 0 0 0 0 0 0 0 0 0 0 0 0 0 0 0 110 111 112 113 0 0 0 0 0 108 109 0 0 0 0 0 0 0
0 0 20 0 6 7 8 9 10 0 29 29 29 29 29 34 33 29 0 0 0 0 0 0 21 0 0 2 0 0 0 63 61 0 0 0 0 0 0 0 0 0 0 21 0 0 0 0 0 0 3 4 5 0 0 0 0 0 0 0 0 0 0 0 0 0 108 109 0 0 0 0 114 115 116 117 118 0 0 0 0 0 110 111 112 113 0 0 0 0 0
0 0 21 0 11 12 13 14 15 0 29 29 29 29 29 35 35 29 36 0 0 0 0 0 0 0 3 4 5 0 0 63 61 0 0 0 0 0 0 0 0 0 0 0 0 0 0 0 0 6 7 8 9 10 0 0 0 0 0 0 0 0 0 0 0 0 110 111 112 113 0 0 0 119 120 121 0 0 0 0 0 114 115 116 117 118 0 0 0 0 0
0 0 0 0 0 16 17 18 19 0 0 0 0 0 0 63 61 0 0 0 0 0 0 0 0 6 7 8 9 10 0 63 61 0 0 0 0 0 0 0 0 0 0 0 0 0 0 0 0 11 12 13 14 15 0 0 0 0 0 0 0 0 0 0 0 114 115 116 117 118 0 0 0 0 122 0 0 0 0 0 0 0 119 120 121 0 0 0 0 0 0
0 0 0 0 0 0 20 0 0 0 0 0 0 0 0 63 61 0 0 0 0 0 0 0 0 11 12 13 14 15 0 63 61 0 0 0 0 0 0 0 0 0 0 0 0 0 0 0 0 0 16 17 18 19 0 0 0 0 0 0 0 0 0 0 0 0 119 120 121 0 0 0 0 0 123 0 0 0 0 0 0 0 0 122 0 0 0 0 0 0 0
0 0 0 0 0 0 21 0 0 0 0 0 0 0 0 63 61 0 0 0 0 0 0 0 0 0 16 17 18 19 0 63 61 0 0 0 0 0 0 0 0 0 0 0 0 0 0 0 0 0 0 20 0 0 0 0 0 0 108 109 0 0 0 0 0 0 0 122 0 0 0 0 0 0 0 0 0 0 0 0 0 0 0 123 0 0 0 0 0 0 0
0 0 0 0 0 0 0 0 0 0 0 0 0 0 67 1 66 0 0 0 0 0 0 0 0 0 0 21 0 0 0 63 61 0 0 0 0 0 0 0 0 0 2 0 0 0 0 0 0 0 0 21 0 0 0 0 0 0 110 111 112 113 0 0 0 0 0 123 0 0 0 0 0 0 0 0 0 0 0 0 0 0 0 0 0 0 0 0 0 0 0
0 0 0 0 0 0 0 0 0 0 0 0 0 0 63 61 0 0 0 0 0 0 0 0 0 0 0 0 0 0 36 63 61 0 0 0 0 0 0 0 0 3 4 5 0 0 0 0 0 0 0 0 0 0 0 0 0 114 115 116 117 118 0 0 0 0 0 0 0 0 0 0 0 108 109 0 0 0 0 0 0 0 0 1 1 1 1 1 1 1 1
0 0 0 0 0 0 0 0 0 0 0 0 0 0 63 1 62 62 62 62 62 62 62 62 62 62 62 62 62 62 62 1 1 68 0 0 0 0 0 0 6 7 8 9 10 0 0 0 0 0 0 0 0 0 0 0 0 0 119 120 121 0 0 0 0 0 0 0 0 0 0 0 0 110 111 112 113 0 0 0 0 0 0 1 1 1 1 1 1 1 1
0 0 0 0 0 0 0 0 0 0 0 0 0 0 63 1 64 64 64 64 64 64 64 64 64 64 64 64 64 64 64 64 1 61 0 0 0 2 0 0 11 12 13 14 15 0 0 0 0 0 0 0 0 0 0 0 0 0 0 122 0 0 0 0 0 0 0 0 0 0 0 0 114 115 116 117 118 0 0 0 0 0 0 1 1 0 0 0 0 0 0
0 0 0 0 0 0 0 0 0 0 0 0 0 0 63 61 0 0 0 0 0 0 0 0 0 0 0 0 0 0 0 0 63 61 0 0 3 4 5 0 0 16 17 18 19 0 0 0 0 0 0 0 0 0 0 0 0 0 0 123 0 0 0 0 0 0 0 0 0 0 0 0 0 119 120 121 0 0 0 0 0 0 0 1 1 0 0 0 0 0 0
0 0 0 0 0 0 0 0 0 0 0 0 0 0 63 1 62 68 0 0 0 0 0 0 0 0 0 0 0 0 0 0 63 61 0 6 7 8 9 10 0 0 20 0 0 0 0 0 0 0 0 0 0 0 0 0 0 0 0 0 0 0 0 0 0 0 0 0 0 0 0 0 0 0 122 0 0 0 0 0 0 0 0 1 1 0 0 108 109 0 0
0 0 0 0 0 0 0 0 0 0 0 0 0 0 65 64 1 61 0 0 0 0 0 0 0 0 0 0 0 0 0 0 63 61 0 11 12 13 14 15 0 0 0 0 0 0 0 0 0 0 0 0 0 0 0 0 0 0 0 0 0 0 0 0 0 0 0 0 0 0 0 0 0 0 123 0 0 0 0 0 0 0 0 1 1 0 0 110 111 112 113
0 0 0 0 0 0 0 0 0 0 0 0 0 0 0 0 63 61 0 0 0 0 0 0 0 0 0 0 0 0 0 0 63 61 0 0 16 17 18 19 0 0 0 58 58 58 58 58 58 58 58 58 58 58 58 58 58 58 58 58 58 58 58 58 58 58 58 58 58 58 58 58 58 58 58 58 58 58 58 58 58 58 58 58 58 0 114 115 116 117 118
0 0 0 0 0 0 0 0 0 0 0 0 0 0 0 0 63 61 0 0 0 0 0 0 0 0 0 0 0 0 0 0 63 61 0 0 0 21 0 0 0 0 0 58 100 96 96 96 96 96 96 96 96 96 96 96 96 96 96 96 96 96 96 96 96 96 96 96 96 96 96 96 96 96 96 96 96 96 96 96 96 96 96 101 58 0 0 119 120 121 0
0 0 0 0 0 0 0 0 0 0 0 0 0 0 0 0 63 61 0 0 0 0 0 0 0 0 0 0 0 0 0 0 63 61 0 0 0 0 0 0 0 0 0 58 103 30 97 97 97 97 97 97 97 97 97 97 97 97 97 97 97 97 97 97 97 97 97 97 97 97 97 97 97 97 97 97 97 97 97 97 97 97 30 102 58 0 0 0 122 0 0
0 0 0 58 58 58 58 58 58 58 58 58 58 58 58 58 58 58 58 58 58 58 58 58 58 58 58 58 58 58 58 58 58 58 58 58 58 58 58 58 58 58 58 58 103 102 58 58 58 58 58 58 58 58 58 58 58 58 58 58 58 58 58 58 58 58 58 58 58 58 58 58 58 58 58 58 58 58 58 58 58 58 103 102 58 0 0 0 123 0 0
0 0 0 58 100 96 96 96 96 96 96 96 96 96 96 96 96 96 96 96 96 96 96 96 96 96 96 96 96 96 96 96 96 96 96 96 96 96 96 96 96 96 96 96 30 102 58 0 0 0 0 0 0 0 0 0 0 0 0 0 0 0 0 0 0 0 0 0 0 0 0 0 0 0 0 0 0 0 0 0 0 58 103 102 58 0 0 0 0 0 0
0 0 0 58 103 30 97 97 97 97 97 97 97 97 97 97 97 97 30 30 30 30 30 30 30 30 30 30 30 30 30 30 30 97 97 97 97 97 97 97 97 30 30 97 97 99 58 0 0 72 80 80 80 80 80 80 80 80 73 0 0 0 0 0 0 0 0 0 0 0 0 0 92 92 92 92 92 0 0 0 0 58 103 102 58 0 0 0 0 0 0
0 0 0 58 103 102 58 58 58 58 58 58 58 58 58 58 58 58 92 92 92 92 92 92 92 92 92 92 92 92 92 92 92 58 58 58 58 58 58 58 58 103 102 58 58 58 58 0 72 80 80 80 80 78 77 80 80 80 80 73 0 0 0 0 0 0 0 0 0 0 0 0 92 92 92 92 92 0 0 0 0 58 103 102 58 0 0 0 0 0 0
0 0 0 58 103 102 58 0 0 0 0 0 0 0 0 0 0 0 92 92 92 92 92 92 92 92 92 92 92 92 92 92 92 0 0 0 0 0 0 0 58 103 102 58 0 0 0 0 69 70 70 70 74 80 80 75 70 70 70 71 0 0 0 0 0 0 0 0 0 0 0 0 89 90 90 90 91 0 0 0 0 58 103 102 58 0 0 0 0 0 0
0 0 0 58 103 102 58 0 0 2 0 0 0 0 0 0 0 0 162 163 163 163 163 182 163 163 163 182 163 163 163 163 164 0 0 0 0 2 0 0 58 103 102 58 0 0 0 0 69 70 70 74 80 80 80 80 75 70 70 71 0 0 0 0 0 0 0 0 0 0 0 0 89 165 165 165 91 0 0 0 0 58 103 102 58 0 0 0 0 0 0
0 0 0 58 103 102 58 0 3 4 5 0 0 0 0 92 92 92 162 163 163 163 163 183 179 180 181 183 163 163 163 163 164 92 92 0 3 4 5 0 58 103 102 58 0 0 0 0 69 70 70 70 69 70 70 71 70 70 70 71 0 0 0 0 0 0 0 0 0 0 0 0 89 90 90 90 91 92 92 92 0 58 103 102 58 0 0 0 0 0 0
0 0 0 58 103 102 58 6 7 8 9 10 0 0 0 162 163 163 162 165 165 165 163 163 163 163 163 163 163 165 165 165 164 163 164 6 7 8 9 10 58 103 102 58 0 0 0 0 69 81 82 70 69 70 70 71 70 81 82 71 0 0 0 0 0 0 0 0 0 0 0 0 89 90 32 90 91 90 90 91 0 58 103 102 58 0 0 0 0 0 0
0 0 0 58 103 102 58 11 12 13 14 15 0 2 0 162 165 163 162 165 165 165 163 163 163 143 143 163 163 165 165 165 164 165 164 11 12 13 14 15 58 103 30 30 62 62 62 62 69 83 84 70 69 85 85 71 70 83 84 71 62 62 62 62 62 62 62 68 0 0 0 0 89 90 33 90 91 90 90 91 0 58 103 102 58 0 0 0 0 0 0
0 0 0 58 103 102 58 0 16 17 18 19 3 4 5 162 165 163 162 163 163 163 163 163 163 144 145 163 163 163 163 163 164 165 164 0 16 17 18 19 58 103 30 30 1 1 1 1 69 70 70 70 69 86 87 71 70 70 70 71 1 1 1 1 1 1 1 1 62 62 62 62 89 90 35 90 91 87 184 185 62 30 30 102 58 0 0 0 0 0 0
0 0 0 58 103 102 58 0 0 20 0 6 7 8 9 162 163 163 162 163 163 163 163 163 163 146 146 163 163 163 163 163 164 163 164 0 0 20 0 0 58 103 30 30 1 1 1 1 69 70 70 70 69 88 88 71 70 70 70 71 1 1 64 64 64 64 64 64 1 1 1 1 1 1 1 1 1 1 1 1 1 30 30 102 58 0 0 0 0 0 0
0 0 0 58 103 102 58 0 0 21 0 11 12 13 14 15 0 0 0 0 0 0 0 103 30 30 30 30 30 30 102 0 0 0 0 0 0 21 0 0 58 103 30 30 1 1 1 1 1 1 1 1 1 1 1 1 1 1 1 1 1 66 0 0 43 42 44 0 65 64 64 64 64 64 64 64 64 64 64 64 64 97 30 102 58 0 0 0 0 0 0
0 0 0 58 103 102 58 0 0 0 0 0 16 17 18 19 0 0 0 0 0 0 0 103 30 30 30 30 30 30 102 0 0 0 0 0 0 0 0 0 58 103 30 30 1 1 1 1 1 1 1 1 1 1 1 1 1 1 1 1 61 0 0 45 42 42 42 44 0 0 0 0 0 0 0 0 0 0 0 0 0 58 103 102 58 0 0 0 0 0 0
0 0 0 58 103 102 58 0 0 0 0 0 0 21 0 0 0 0 0 0 0 0 31 103 30 30 30 30 30 30 102 31 0 0 0 0 0 0 0 0 58 103 30 30 64 64 64 64 64 64 64 64 64 64 64 64 1 1 1 64 66 0 43 42 42 42 42 42 44 0 0 0 0 0 0 0 0 0 0 0 0 58 103 102 58 0 0 0 0 0 0
0 0 0 58 103 30 96 96 96 96 96 96 96 96 96 96 96 96 96 96 96 96 96 30 30 30 30 30 30 30 30 101 0 0 0 0 0 0 0 0 58 103 102 58 0 0 0 0 0 0 0 0 0 0 0 0 63 1 61 0 0 43 42 42 42 42 42 42 42 44 0 0 0 0 0 0 0 0 0 0 0 58 103 102 58 0 0 0 0 0 0
0 0 0 58 103 30 97 97 97 97 97 97 97 97 97 97 30 30 30 30 30 30 97 97 97 97 97 97 97 97 30 30 96 101 0 0 0 0 0 0 58 103 102 58 0 0 0 0 0 0 0 0 0 0 0 0 63 1 61 0 0 0 37 154 155 156 157 37 37 0 0 0 0 0 0 0 0 0 0 0 0 58 103 102 58 0 0 0 0 0 0
0 0 0 58 103 102 58 22 22 22 22 22 22 22 22 22 98 30 30 30 30 99 22 22 22 22 22 22 22 22 98 97 30 102 0 0 0 0 0 0 58 103 102 58 0 0 0 0 0 0 0 0 0 0 0 0 63 1 61 0 0 0 37 37 37 46 48 47 37 0 0 0 0 0 0 0 0 0 0 0 0 58 103 102 58 0 0 0 0 0 0
0 0 0 58 103 102 58 22 152 152 152 152 152 22 22 22 22 98 30 30 99 22 22 22 22 22 22 22 22 22 22 22 103 102 0 0 0 0 0 0 58 103 102 58 0 0 0 0 0 0 0 0 0 0 0 0 63 1 61 0 0 0 37 40 37 46 48 47 37 0 0 0 0 0 0 0 0 0 0 0 0 58 103 102 58 0 0 0 0 0 0
0 0 0 58 103 102 58 22 152 152 152 152 152 22 22 22 22 22 103 102 22 22 22 22 22 22 22 22 22 22 22 22 103 102 0 0 0 0 0 0 58 103 102 58 0 0 0 0 0 0 0 0 0 0 0 0 63 1 1 62 62 62 37 39 37 46 48 47 37 62 68 0 0 0 0 0 0 0 0 0 0 58 103 102 58 0 0 0 0 0 0
0 0 0 58 103 102 58 22 124 147 147 147 148 152 152 152 22 22 103 102 22 22 22 22 22 22 22 22 22 22 22 22 103 102 0 0 0 0 0 58 58 103 102 58 58 0 0 0 0 0 0 0 0 0 0 0 65 64 64 64 1 1 37 38 37 37 37 37 37 1 61 0 0 0 0 0 0 0 0 0 31 58 103 102 58 0 0 0 0 0 0
0 0 0 58 103 102 58 22 124 147 147 147 148 147 147 148 22 22 103 102 22 22 22 22 22 22 22 22 22 22 22 22 103 102 0 0 0 0 0 58 100 30 30 101 58 58 58 58 58 58 58 58 31 0 0 0 0 0 0 0 65 64 64 64 64 64 64 64 64 64 66 0 0 0 0 58 58 58 58 58 58 58 103 102 58 58 58 0 0 0 0
0 0 0 58 103 102 58 22 124 32 32 147 148 147 147 148 22 22 103 102 22 22 22 22 22 22 22 22 22 22 22 22 103 30 96 96 96 96 96 96 30 30 30 30 96 96 96 96 96 96 101 58 58 58 58 58 58 58 58 58 58 58 58 58 58 58 58 58 58 58 58 58 58 58 58 58 100 96 96 96 96 96 30 30 96 101 58 0 0 0 0
0 0 0 58 103 102 58 22 124 34 33 147 148 147 147 148 22 22 103 102 22 22 92 92 92 92 92 92 92 92 92 92 92 92 92 92 92 92 97 97 30 30 30 30 97 97 97 97 30 30 30 96 96 96 96 96 96 96 96 96 96 96 96 96 96 96 96 96 96 96 96 96 96 96 96 96 30 30 97 97 97 97 97 97 30 102 58 0 0 0 0
0 0 0 58 103 102 58 22 124 35 35 147 148 147 147 148 22 22 103 102 22 22 92 92 92 92 92 92 92 92 92 92 92 92 92 92 92 92 22 58 98 30 30 99 58 58 58 58 92 92 92 92 92 92 30 30 30 30 30 30 30 30 92 92 92 92 92 97 97 153 153 153 153 97 97 97 97 99 58 58 58 58 58 58 103 102 58 0 0 0 0
0 0 0 58 103 102 58 22 22 22 22 22 22 22 22 22 22 22 103 102 22 22 89 94 95 90 90 90 90 90 90 90 90 90 90 90 90 91 22 58 58 103 102 58 58 22 22 22 92 92 92 92 92 92 152 152 152 152 152 152 152 152 92 92 92 92 92 58 58 124 147 147 148 153 153 153 153 153 58 22 22 22 22 58 103 102 58 0 0 0 0
0 0 0 58 103 102 58 22 22 22 22 22 22 22 22 22 22 22 103 102 22 22 89 93 93 93 90 93 93 93 90 93 93 93 90 93 93 91 22 22 58 103 102 58 22 22 22 22 69 70 70 70 70 71 152 152 152 152 152 152 152 152 29 29 29 29 29 22 22 124 171 172 148 153 153 153 153 153 22 22 22 22 22 58 103 102 58 0 0 0 0
58 58 58 58 103 102 58 22 153 153 153 22 22 22 22 22 22 22 103 102 22 22 89 93 93 93 90 93 93 93 90 93 93 93 90 93 93 91 22 22 58 103 102 58 22 22 22 22 69 165 70 70 165 71 149 150 150 150 150 150 150 151 29 29 29 165 29 22 22 124 173 174 148 147 147 147 147 148 22 22 22 22 22 58 103 102 58 0 0 0 0
96 96 96 96 30 102 58 22 153 153 153 22 22 22 22 22 22 22 103 102 22 22 89 90 90 90 90 90 90 90 90 90 90 90 90 90 90 91 22 22 58 103 102 58 22 22 22 22 69 70 70 70 70 71 149 150 150 150 150 150 150 151 29 32 29 29 29 22 22 124 147 147 148 147 165 147 165 148 22 22 22 22 22 58 103 102 58 0 0 0 0
97 97 97 97 30 102 58 22 89 90 91 22 92 92 92 92 92 22 103 102 22 22 89 90 86 87 90 90 86 87 90 90 86 87 90 90 90 91 22 22 58 103 102 58 22 22 22 22 69 70 158 158 70 71 149 150 150 150 150 150 150 151 29 33 29 29 29 22 22 124 85 85 148 147 147 147 147 148 22 22 22 22 22 58 103 102 58 0 0 0 0
58 58 58 58 103 102 58 22 89 165 91 22 105 106 175 176 107 22 103 102 22 22 22 22 22 22 22 22 22 22 22 22 22 22 22 22 22 22 22 22 58 103 102 58 22 22 22 22 69 70 159 160 70 71 149 150 86 87 150 150 150 151 29 35 29 29 29 22 22 124 86 87 148 147 147 147 147 148 22 22 22 22 22 58 103 102 58 0 0 0 0
0 0 0 58 103 102 58 22 89 90 91 22 105 106 177 178 107 96 30 30 101 22 22 22 22 22 22 22 22 22 22 22 22 22 22 22 22 22 22 22 58 103 102 58 22 22 22 22 22 22 22 22 22 22 22 22 22 22 22 22 22 22 22 22 22 22 22 22 22 22 22 22 22 22 22 22 22 22 22 22 22 22 22 58 103 102 58 0 0 0 0
0 0 0 58 103 102 58 22 89 86 91 22 105 86 106 106 107 30 30 30 30 96 96 96 96 96 96 96 101 22 22 22 22 22 22 22 22 22 22 22 58 103 102 58 22 22 22 22 22 22 22 22 22 22 22 22 22 22 22 22 22 22 22 22 22 22 22 22 22 22 22 22 22 22 22 22 22 22 22 22 22 22 22 58 103 102 58 0 0 0 0
0 0 0 58 103 102 58 22 22 22 22 22 22 22 22 103 30 30 30 30 30 30 30 30 30 30 30 30 30 96 101 22 22 22 22 22 22 22 22 22 58 103 102 58 22 22 22 22 22 22 22 22 22 22 22 22 22 22 22 22 22 22 22 22 22 22 22 22 22 22 22 22 22 22 22 22 22 22 22 22 22 22 22 58 103 102 58 0 0 0 0
0 0 0 58 103 30 96 96 96 96 96 96 96 96 96 30 30 30 30 30 30 30 30 97 97 97 97 97 97 30 30 96 96 96 96 96 96 96 96 96 58 103 102 58 22 22 22 22 22 22 22 22 22 22 22 22 22 22 22 22 22 22 22 22 22 22 22 22 22 22 22 22 22 22 22 22 22 22 22 22 22 22 22 58 103 102 58 0 0 0 0
0 0 0 58 103 30 97 97 97 97 97 97 97 97 97 97 30 30 30 30 30 30 99 0 0 0 0 0 0 98 30 30 30 30 30 30 30 30 30 30 58 103 102 58 22 22 22 22 22 22 22 22 22 22 22 22 22 22 22 22 22 22 22 22 22 22 22 22 22 22 22 22 22 22 22 22 22 22 22 22 22 22 22 58 103 102 58 0 0 0 0
0 0 0 58 103 102 58 31 0 0 0 0 0 0 0 31 98 30 30 30 30 99 31 108 109 0 0 0 0 31 98 97 97 97 97 97 97 97 97 97 58 103 102 58 22 22 22 22 22 22 22 22 152 152 152 152 152 152 152 152 152 152 152 152 152 152 152 152 152 152 152 152 152 152 152 22 22 22 22 22 22 22 22 58 103 102 58 0 0 0 0
0 0 0 58 103 102 58 0 0 0 0 0 0 0 2 0 0 98 30 30 102 0 0 110 111 112 113 0 0 0 0 0 0 0 108 109 0 0 0 0 58 103 102 58 22 22 22 22 22 22 22 22 152 152 152 152 152 152 152 152 152 152 152 152 152 152 152 152 152 152 152 152 152 152 152 22 22 22 22 22 22 22 22 58 103 102 58 0 0 0 0
0 0 0 58 103 102 58 0 0 0 0 0 0 3 4 5 0 0 98 30 102 0 114 115 116 117 118 0 0 0 0 0 0 0 110 111 112 113 0 0 58 103 102 58 22 22 22 22 22 22 22 22 105 106 106 106 106 106 106 106 106 106 106 106 106 106 106 106 106 106 106 106 106 106 107 22 22 22 22 22 22 22 22 58 103 102 58 0 0 0 0
0 0 0 58 103 102 58 0 0 2 0 0 6 7 8 9 10 0 0 103 102 0 0 119 120 121 0 0 2 0 0 0 0 114 115 116 117 118 0 0 58 103 102 58 22 22 22 22 22 22 22 22 105 106 165 106 106 165 106 106 165 106 106 165 106 106 165 106 106 186 188 106 106 165 107 22 22 22 22 22 22 22 22 58 103 102 58 0 0 0 0
0 0 0 58 103 102 58 0 3 4 5 0 11 12 13 14 15 0 0 103 102 0 0 0 122 0 0 3 4 5 0 0 0 0 119 120 121 0 0 0 58 103 102 58 22 22 22 22 22 22 22 22 105 106 106 106 106 106 106 106 106 106 106 106 106 106 106 106 106 187 189 106 106 106 107 22 22 22 22 22 22 22 22 58 103 102 58 0 0 0 0
0 0 0 58 103 102 58 6 7 8 9 10 0 16 17 18 19 0 0 103 102 0 0 0 123 0 6 7 8 9 10 0 0 0 0 122 0 0 58 58 58 103 102 58 58 58 58 58 22 22 22 22 105 106 106 106 106 106 106 106 106 106 106 106 106 106 106 106 106 106 106 106 106 106 107 22 22 22 22 22 22 22 22 58 103 102 58 0 0 0 0
0 0 0 58 103 102 58 11 12 13 14 15 0 0 21 0 0 0 0 103 102 0 0 0 0 0 11 12 13 14 15 0 0 0 0 123 0 58 58 100 96 30 30 96 96 96 101 58 22 22 22 22 105 106 106 106 106 106 106 106 106 159 160 106 106 106 106 106 106 106 106 106 106 106 107 22 22 22 22 22 22 22 22 58 103 102 58 0 0 0 0
0 0 0 58 103 102 58 0 16 17 18 19 0 0 0 0 0 0 0 103 102 0 0 0 0 0 0 16 17 18 19 0 0 0 0 0 58 58 100 30 97 97 97 97 97 30 102 58 22 22 22 22 22 22 22 22 22 22 22 22 1 1 1 1 22 22 22 22 22 22 22 22 22 22 22 22 22 22 22 22 22 22 22 58 103 102 58 0 0 0 0
0 0 0 58 103 102 58 58 0 21 0 0 0 0 0 0 0 0 0 103 102 0 0 0 0 0 0 0 21 0 0 0 0 0 0 58 58 100 30 99 58 58 58 58 58 103 102 58 22 22 22 22 22 22 22 22 22 22 22 22 64 64 64 64 22 22 22 22 22 22 22 22 22 22 22 22 22 22 22 22 22 22 22 58 103 102 58 0 0 0 0
0 0 0 58 98 30 101 58 58 0 0 0 0 0 0 0 0 0 31 103 102 31 0 0 0 0 0 0 0 0 0 0 0 0 0 58 100 30 99 58 58 0 0 0 58 103 102 58 22 22 22 22 22 22 22 22 22 22 22 22 22 22 22 22 22 22 22 22 22 22 22 22 22 22 22 22 22 22 22 22 22 22 58 58 103 102 58 0 0 0 0
10 0 2 58 58 98 30 101 58 58 58 58 58 58 58 58 58 58 58 103 102 58 58 58 58 58 58 58 58 58 58 58 58 58 58 58 103 102 58 58 0 0 0 0 58 103 102 58 58 58 58 58 58 58 58 58 58 58 58 58 58 58 58 58 58 58 58 58 58 58 58 58 58 58 58 58 58 58 58 58 58 58 58 100 30 99 58 0 0 0 0
15 3 4 5 58 58 98 30 96 96 96 96 96 96 96 96 96 96 96 30 30 96 96 96 96 96 96 96 96 96 96 96 96 96 96 96 30 102 58 0 0 0 0 0 58 103 30 96 96 96 96 96 96 96 96 96 96 96 96 96 96 96 96 96 96 96 96 96 96 96 96 96 96 96 96 96 96 96 96 96 96 96 96 30 99 58 58 0 0 0 0
19 7 8 9 10 58 58 98 97 97 97 97 97 97 97 97 97 97 97 97 97 97 97 97 97 97 97 97 97 97 97 97 97 97 97 97 97 99 58 0 0 0 0 0 58 98 97 97 97 97 97 97 97 97 97 97 97 97 97 97 97 97 97 97 97 97 97 97 97 97 97 97 97 97 97 97 97 97 97 97 97 97 97 99 58 58 0 0 0 0 0
11 12 13 14 0 0 58 58 58 58 58 58 58 58 58 58 58 58 58 58 58 58 58 58 58 58 58 58 58 58 58 58 58 58 58 58 58 58 58 0 0 0 0 0 58 58 58 58 58 58 58 58 58 58 58 58 58 58 58 58 58 58 58 58 58 58 58 58 58 58 58 58 58 58 58 58 58 58 58 58 58 58 58 58 58 0 0 0 0 0 0
0 16 17 18 19 0 0 0 0 0 0 0 0 0 0 0 0 0 0 0 0 0 0 0 0 0 0 0 0 0 0 0 0 0 0 0 0 0 0 0 0 0 0 0 0 0 0 0 0 0 0 0 0 0 0 0 0 0 0 0 0 0 0 0 0 0 0 0 0 0 0 0 0 0 0 0 0 0 0 0 0 0 0 0 0 0 0 0 0 0 0
0 0 190 0 0 0 0 0 0 0 0 0 0 0 0 0 0 0 0 0 0 0 0 0 0 0 0 0 0 0 0 0 0 0 0 0 0 0 0 0 0 0 0 0 0 0 0 0 0 0 0 0 0 0 0 0 0 0 0 0 0 0 0 0 0 0 0 0 0 0 0 0 0 0 0 0 0 0 0 0 0 0 0 0 0 0 0 0 0 0 0
0 0 191 0 0 0 0 0 0 0 0 0 0 0 0 0 0 0 0 0 0 0 0 0 0 0 0 0 0 0 0 0 0 0 0 0 0 0 0 0 0 0 0 0 0 0 0 0 0 0 0 0 0 0 0 0 0 0 0 0 0 0 0 0 0 0 0 0 0 0 0 0 0 0 0 0 0 0 0 0 0 0 0 0 0 0 0 0 0 0 0